Acidimicrobiia	sk__Bacteria.p__Actinobacteria.c__Acidimicrobiia	sk__Bacteria.nr__Terrabacteria_group.p__Actinobacteria.c__Acidimicrobiia
Acidithiobacillales	sk__Bacteria.p__Proteobacteria.c__Acidithiobacillia.o__Acidithiobacillales	sk__Bacteria.p__Proteobacteria.c__Acidithiobacillia.o__Acidithiobacillales
Acidobacteria	sk__Bacteria.p__Acidobacteria	sk__Bacteria.p__Acidobacteria
Acidobacteriia	sk__Bacteria.p__Acidobacteria.c__Acidobacteriia	sk__Bacteria.p__Acidobacteria.c__Acidobacteriia
Aconoidasida	sk__Eukaryota.p__Apicomplexa.c__Aconoidasida	sk__Eukaryota.nr__Sar.nr__Alveolata.p__Apicomplexa.c__Aconoidasida
Actinobacteria	sk__Bacteria.p__Actinobacteria.c__Actinobacteria	sk__Bacteria.nr__Terrabacteria_group.p__Actinobacteria.c__Actinobacteria
Actinopolysporales	sk__Bacteria.p__Actinobacteria.c__Actinobacteria.o__Actinopolysporales	sk__Bacteria.nr__Terrabacteria_group.p__Actinobacteria.c__Actinobacteria.o__Actinopolysporales
Actinopterygii	sk__Eukaryota.k__Metazoa.p__Chordata.sc__Actinopterygii	sk__Eukaryota.nr__Opisthokonta.k__Metazoa.nr__Eumetazoa.nr__Bilateria.nr__Deuterostomia.p__Chordata.nr__Vertebrata.nr__Gnathostomata.nr__Teleostomi.nr__Euteleostomi.sc__Actinopterygii
Aerococcaceae	sk__Bacteria.p__Firmicutes.c__Bacilli.o__Lactobacillales.f__Aerococcaceae	sk__Bacteria.nr__Terrabacteria_group.p__Firmicutes.c__Bacilli.o__Lactobacillales.f__Aerococcaceae
Aeromonadales	sk__Bacteria.p__Proteobacteria.c__Gammaproteobacteria.o__Aeromonadales	sk__Bacteria.p__Proteobacteria.c__Gammaproteobacteria.o__Aeromonadales
Afrotheria	sk__Eukaryota.k__Metazoa.p__Chordata.c__Mammalia.so__Afrotheria	sk__Eukaryota.nr__Opisthokonta.k__Metazoa.nr__Eumetazoa.nr__Bilateria.nr__Deuterostomia.p__Chordata.nr__Vertebrata.nr__Gnathostomata.nr__Teleostomi.nr__Euteleostomi.sc__Sarcopterygii.nr__Dipnotetrapodomorpha.nr__Tetrapoda.nr__Amniota.c__Mammalia.nr__Theria.nr__Eutheria.so__Afrotheria
Agaricales	sk__Eukaryota.k__Fungi.p__Basidiomycota.c__Agaricomycetes.o__Agaricales	sk__Eukaryota.nr__Opisthokonta.k__Fungi.p__Basidiomycota.c__Agaricomycetes.o__Agaricales
Agaricomycetes	sk__Eukaryota.k__Fungi.p__Basidiomycota.c__Agaricomycetes	sk__Eukaryota.nr__Opisthokonta.k__Fungi.p__Basidiomycota.c__Agaricomycetes
Agaricomycetes incertae sedis	sk__Eukaryota.k__Fungi.p__Basidiomycota.c__Agaricomycetes.o__Agaricales.nr__Agaricales_incertae_sedis	sk__Eukaryota.nr__Opisthokonta.k__Fungi.p__Basidiomycota.c__Agaricomycetes.o__Agaricales.nr__Agaricales_incertae_sedis
Alcaligenaceae	sk__Bacteria.p__Proteobacteria.c__Betaproteobacteria.o__Burkholderiales.f__Alcaligenaceae	sk__Bacteria.p__Proteobacteria.c__Betaproteobacteria.o__Burkholderiales.f__Alcaligenaceae
Alicyclobacillaceae	sk__Bacteria.p__Firmicutes.c__Bacilli.o__Bacillales.f__Alicyclobacillaceae	sk__Bacteria.nr__Terrabacteria_group.p__Firmicutes.c__Bacilli.o__Bacillales.f__Alicyclobacillaceae
Alloprevotella	sk__Bacteria.p__Bacteroidetes.c__Bacteroidia.o__Bacteroidales.f__Prevotellaceae.g__Alloprevotella	sk__Bacteria.nr__FCB_group.nr__Bacteroidetes/Chlorobi_group.p__Bacteroidetes.c__Bacteroidia.o__Bacteroidales.f__Prevotellaceae.g__Alloprevotella
Alphaproteobacteria	sk__Bacteria.p__Proteobacteria.c__Alphaproteobacteria	sk__Bacteria.p__Proteobacteria.c__Alphaproteobacteria
Alteromonadaceae	sk__Bacteria.p__Proteobacteria.c__Gammaproteobacteria.o__Alteromonadales.f__Alteromonadaceae	sk__Bacteria.p__Proteobacteria.c__Gammaproteobacteria.o__Alteromonadales.f__Alteromonadaceae
Alteromonadales genera incertae sedis	sk__Bacteria.p__Proteobacteria.c__Gammaproteobacteria.o__Alteromonadales.nr__Alteromonadales_genera_incertae_sedis	sk__Bacteria.p__Proteobacteria.c__Gammaproteobacteria.o__Alteromonadales.nr__Alteromonadales_genera_incertae_sedis
Amoebozoa	sk__Eukaryota.nr__Amoebozoa	sk__Eukaryota.nr__Amoebozoa
Anoxybacillus	sk__Bacteria.p__Firmicutes.c__Bacilli.o__Bacillales.f__Bacillaceae.g__Anoxybacillus	sk__Bacteria.nr__Terrabacteria_group.p__Firmicutes.c__Bacilli.o__Bacillales.f__Bacillaceae.g__Anoxybacillus
Apicomplexa	sk__Eukaryota.p__Apicomplexa	sk__Eukaryota.nr__Sar.nr__Alveolata.p__Apicomplexa
Aquificae	sk__Bacteria.p__Aquificae.c__Aquificae	sk__Bacteria.p__Aquificae.c__Aquificae
Aquimarina	sk__Bacteria.p__Bacteroidetes.c__Flavobacteriia.o__Flavobacteriales.f__Flavobacteriaceae.g__Aquimarina	sk__Bacteria.nr__FCB_group.nr__Bacteroidetes/Chlorobi_group.p__Bacteroidetes.c__Flavobacteriia.o__Flavobacteriales.f__Flavobacteriaceae.g__Aquimarina
Archaea	sk__Archaea	sk__Archaea
Archaeoglobi	sk__Archaea.p__Euryarchaeota.c__Archaeoglobi	sk__Archaea.p__Euryarchaeota.c__Archaeoglobi
Arenibacter	sk__Bacteria.p__Bacteroidetes.c__Flavobacteriia.o__Flavobacteriales.f__Flavobacteriaceae.g__Arenibacter	sk__Bacteria.nr__FCB_group.nr__Bacteroidetes/Chlorobi_group.p__Bacteroidetes.c__Flavobacteriia.o__Flavobacteriales.f__Flavobacteriaceae.g__Arenibacter
Arthrodermataceae	sk__Eukaryota.k__Fungi.p__Ascomycota.c__Eurotiomycetes.o__Onygenales.f__Arthrodermataceae	sk__Eukaryota.nr__Opisthokonta.k__Fungi.p__Ascomycota.nr__saccharomyceta.nr__leotiomyceta.c__Eurotiomycetes.o__Onygenales.f__Arthrodermataceae
Arthropoda	sk__Eukaryota.k__Metazoa.p__Arthropoda	sk__Eukaryota.nr__Opisthokonta.k__Metazoa.nr__Eumetazoa.nr__Bilateria.nr__Protostomia.nr__Ecdysozoa.nr__Panarthropoda.p__Arthropoda
Ascomycota	sk__Eukaryota.k__Fungi.p__Ascomycota	sk__Eukaryota.nr__Opisthokonta.k__Fungi.p__Ascomycota
asterids	sk__Eukaryota.k__Viridiplantae.p__Streptophyta.c__Magnoliopsida.nr__asterids	sk__Eukaryota.k__Viridiplantae.p__Streptophyta.nr__Embryophyta.nr__Tracheophyta.nr__Euphyllophyta.nr__Spermatophyta.c__Magnoliopsida.nr__Mesangiospermae.nr__eudicotyledons.nr__Gunneridae.nr__Pentapetalae.nr__asterids
Aurantimonadaceae	sk__Bacteria.p__Proteobacteria.c__Alphaproteobacteria.o__Rhizobiales.f__Aurantimonadaceae	sk__Bacteria.p__Proteobacteria.c__Alphaproteobacteria.o__Rhizobiales.f__Aurantimonadaceae
Aves	sk__Eukaryota.k__Metazoa.p__Chordata.c__Aves	sk__Eukaryota.nr__Opisthokonta.k__Metazoa.nr__Eumetazoa.nr__Bilateria.nr__Deuterostomia.p__Chordata.nr__Vertebrata.nr__Gnathostomata.nr__Teleostomi.nr__Euteleostomi.sc__Sarcopterygii.nr__Dipnotetrapodomorpha.nr__Tetrapoda.nr__Amniota.nr__Sauropsida.nr__Sauria.nr__Archelosauria.nr__Archosauria.nr__Dinosauria.nr__Saurischia.nr__Theropoda.nr__Coelurosauria.c__Aves
Bacillales incertae sedis	sk__Bacteria.p__Firmicutes.c__Bacilli.o__Bacillales	sk__Bacteria.nr__Terrabacteria_group.p__Firmicutes.c__Bacilli.o__Bacillales
Bacillariophyta	sk__Eukaryota.p__Bacillariophyta	sk__Eukaryota.nr__Sar.nr__Stramenopiles.nr__Ochrophyta.p__Bacillariophyta
Bacilli	sk__Bacteria.p__Firmicutes.c__Bacilli	sk__Bacteria.nr__Terrabacteria_group.p__Firmicutes.c__Bacilli
Bacillus	sk__Bacteria.p__Firmicutes.c__Bacilli.o__Bacillales.f__Bacillaceae.g__Bacillus	sk__Bacteria.nr__Terrabacteria_group.p__Firmicutes.c__Bacilli.o__Bacillales.f__Bacillaceae.g__Bacillus
Bacteria	sk__Bacteria	sk__Bacteria
Bacteroidaceae	sk__Bacteria.p__Bacteroidetes.c__Bacteroidia.o__Bacteroidales.f__Bacteroidaceae	sk__Bacteria.nr__FCB_group.nr__Bacteroidetes/Chlorobi_group.p__Bacteroidetes.c__Bacteroidia.o__Bacteroidales.f__Bacteroidaceae
Bacteroidetes	sk__Bacteria.p__Bacteroidetes	sk__Bacteria.nr__FCB_group.nr__Bacteroidetes/Chlorobi_group.p__Bacteroidetes
Bacteroidetes Order II. Incertae sedis	sk__Bacteria.p__Bacteroidetes.o__Bacteroidetes_Order_II__Incertae_sedis	sk__Bacteria.nr__FCB_group.nr__Bacteroidetes/Chlorobi_group.p__Bacteroidetes.o__Bacteroidetes_Order_II__Incertae_sedis
Bacteroidia	sk__Bacteria.p__Bacteroidetes.c__Bacteroidia	sk__Bacteria.nr__FCB_group.nr__Bacteroidetes/Chlorobi_group.p__Bacteroidetes.c__Bacteroidia
Bartonellaceae	sk__Bacteria.p__Proteobacteria.c__Alphaproteobacteria.o__Rhizobiales.f__Bartonellaceae	sk__Bacteria.p__Proteobacteria.c__Alphaproteobacteria.o__Rhizobiales.f__Bartonellaceae
Basidiomycota	sk__Eukaryota.k__Fungi.p__Basidiomycota	sk__Eukaryota.nr__Opisthokonta.k__Fungi.p__Basidiomycota
Bdellovibrionales	sk__Bacteria.p__Proteobacteria.c__Oligoflexia.o__Bdellovibrionales	sk__Bacteria.p__Proteobacteria.c__Oligoflexia.o__Bdellovibrionales
Beijerinckiaceae	sk__Bacteria.p__Proteobacteria.c__Alphaproteobacteria.o__Rhizobiales.f__Beijerinckiaceae	sk__Bacteria.p__Proteobacteria.c__Alphaproteobacteria.o__Rhizobiales.f__Beijerinckiaceae
Betaproteobacteria	sk__Bacteria.p__Proteobacteria.c__Betaproteobacteria	sk__Bacteria.p__Proteobacteria.c__Betaproteobacteria
Bifidobacteriales	sk__Bacteria.p__Actinobacteria.c__Actinobacteria.o__Bifidobacteriales	sk__Bacteria.nr__Terrabacteria_group.p__Actinobacteria.c__Actinobacteria.o__Bifidobacteriales
Bilateria	sk__Eukaryota.k__Metazoa.nr__Bilateria	sk__Eukaryota.nr__Opisthokonta.k__Metazoa.nr__Eumetazoa.nr__Bilateria
Blattabacteriaceae	sk__Bacteria.p__Bacteroidetes.c__Flavobacteriia.o__Flavobacteriales.f__Blattabacteriaceae	sk__Bacteria.nr__FCB_group.nr__Bacteroidetes/Chlorobi_group.p__Bacteroidetes.c__Flavobacteriia.o__Flavobacteriales.f__Blattabacteriaceae
Blautia	sk__Bacteria.p__Firmicutes.c__Clostridia.o__Clostridiales.f__Lachnospiraceae.g__Blautia	sk__Bacteria.nr__Terrabacteria_group.p__Firmicutes.c__Clostridia.o__Clostridiales.f__Lachnospiraceae.g__Blautia
Bradyrhizobiaceae	sk__Bacteria.p__Proteobacteria.c__Alphaproteobacteria.o__Rhizobiales.f__Bradyrhizobiaceae	sk__Bacteria.p__Proteobacteria.c__Alphaproteobacteria.o__Rhizobiales.f__Bradyrhizobiaceae
Brassicales	sk__Eukaryota.k__Viridiplantae.p__Streptophyta.c__Magnoliopsida.o__Brassicales	sk__Eukaryota.k__Viridiplantae.p__Streptophyta.nr__Embryophyta.nr__Tracheophyta.nr__Euphyllophyta.nr__Spermatophyta.c__Magnoliopsida.nr__Mesangiospermae.nr__eudicotyledons.nr__Gunneridae.nr__Pentapetalae.nr__rosids.nr__malvids.o__Brassicales
Brevibacteriaceae	sk__Bacteria.p__Actinobacteria.c__Actinobacteria.o__Micrococcales.f__Brevibacteriaceae	sk__Bacteria.nr__Terrabacteria_group.p__Actinobacteria.c__Actinobacteria.o__Micrococcales.f__Brevibacteriaceae
Brucellaceae	sk__Bacteria.p__Proteobacteria.c__Alphaproteobacteria.o__Rhizobiales.f__Brucellaceae	sk__Bacteria.p__Proteobacteria.c__Alphaproteobacteria.o__Rhizobiales.f__Brucellaceae
Buchnera	sk__Bacteria.p__Proteobacteria.c__Gammaproteobacteria.o__Enterobacterales.f__Erwiniaceae.g__Buchnera	sk__Bacteria.p__Proteobacteria.c__Gammaproteobacteria.o__Enterobacterales.f__Erwiniaceae.g__Buchnera
Burkholderiaceae	sk__Bacteria.p__Proteobacteria.c__Betaproteobacteria.o__Burkholderiales.f__Burkholderiaceae	sk__Bacteria.p__Proteobacteria.c__Betaproteobacteria.o__Burkholderiales.f__Burkholderiaceae
Butyrivibrio	sk__Bacteria.p__Firmicutes.c__Clostridia.o__Clostridiales.f__Lachnospiraceae.g__Butyrivibrio	sk__Bacteria.nr__Terrabacteria_group.p__Firmicutes.c__Clostridia.o__Clostridiales.f__Lachnospiraceae.g__Butyrivibrio
Capnocytophaga	sk__Bacteria.p__Bacteroidetes.c__Flavobacteriia.o__Flavobacteriales.f__Flavobacteriaceae.g__Capnocytophaga	sk__Bacteria.nr__FCB_group.nr__Bacteroidetes/Chlorobi_group.p__Bacteroidetes.c__Flavobacteriia.o__Flavobacteriales.f__Flavobacteriaceae.g__Capnocytophaga
Carnivora	sk__Eukaryota.k__Metazoa.p__Chordata.c__Mammalia.o__Carnivora	sk__Eukaryota.nr__Opisthokonta.k__Metazoa.nr__Eumetazoa.nr__Bilateria.nr__Deuterostomia.p__Chordata.nr__Vertebrata.nr__Gnathostomata.nr__Teleostomi.nr__Euteleostomi.sc__Sarcopterygii.nr__Dipnotetrapodomorpha.nr__Tetrapoda.nr__Amniota.c__Mammalia.nr__Theria.nr__Eutheria.nr__Boreoeutheria.so__Laurasiatheria.o__Carnivora
Carnobacteriaceae	sk__Bacteria.p__Firmicutes.c__Bacilli.o__Lactobacillales.f__Carnobacteriaceae	sk__Bacteria.nr__Terrabacteria_group.p__Firmicutes.c__Bacilli.o__Lactobacillales.f__Carnobacteriaceae
Caudovirales	sk__Viruses.o__Caudovirales	sk__Viruses.o__Caudovirales
Caulobacterales	sk__Bacteria.p__Proteobacteria.c__Alphaproteobacteria.o__Caulobacterales	sk__Bacteria.p__Proteobacteria.c__Alphaproteobacteria.o__Caulobacterales
Cellulomonadaceae	sk__Bacteria.p__Actinobacteria.c__Actinobacteria.o__Micrococcales.f__Cellulomonadaceae	sk__Bacteria.nr__Terrabacteria_group.p__Actinobacteria.c__Actinobacteria.o__Micrococcales.f__Cellulomonadaceae
Cellulophaga	sk__Bacteria.p__Bacteroidetes.c__Flavobacteriia.o__Flavobacteriales.f__Flavobacteriaceae.g__Cellulophaga	sk__Bacteria.nr__FCB_group.nr__Bacteroidetes/Chlorobi_group.p__Bacteroidetes.c__Flavobacteriia.o__Flavobacteriales.f__Flavobacteriaceae.g__Cellulophaga
Cellvibrio	sk__Bacteria.p__Proteobacteria.c__Gammaproteobacteria.o__Cellvibrionales.f__Cellvibrionaceae.g__Cellvibrio	sk__Bacteria.p__Proteobacteria.c__Gammaproteobacteria.o__Cellvibrionales.f__Cellvibrionaceae.g__Cellvibrio
Cercopithecoidea	sk__Eukaryota.k__Metazoa.p__Chordata.c__Mammalia.o__Primates.sf__Cercopithecoidea	sk__Eukaryota.nr__Opisthokonta.k__Metazoa.nr__Eumetazoa.nr__Bilateria.nr__Deuterostomia.p__Chordata.nr__Vertebrata.nr__Gnathostomata.nr__Teleostomi.nr__Euteleostomi.sc__Sarcopterygii.nr__Dipnotetrapodomorpha.nr__Tetrapoda.nr__Amniota.c__Mammalia.nr__Theria.nr__Eutheria.nr__Boreoeutheria.so__Euarchontoglires.o__Primates.sf__Cercopithecoidea
Cetartiodactyla	sk__Eukaryota.k__Metazoa.p__Chordata.c__Mammalia.o__Artiodactyla	sk__Eukaryota.nr__Opisthokonta.k__Metazoa.nr__Eumetazoa.nr__Bilateria.nr__Deuterostomia.p__Chordata.nr__Vertebrata.nr__Gnathostomata.nr__Teleostomi.nr__Euteleostomi.sc__Sarcopterygii.nr__Dipnotetrapodomorpha.nr__Tetrapoda.nr__Amniota.c__Mammalia.nr__Theria.nr__Eutheria.nr__Boreoeutheria.so__Laurasiatheria.o__Artiodactyla
Chaetomiaceae	sk__Eukaryota.k__Fungi.p__Ascomycota.c__Sordariomycetes.o__Sordariales.f__Chaetomiaceae	sk__Eukaryota.nr__Opisthokonta.k__Fungi.p__Ascomycota.nr__saccharomyceta.nr__leotiomyceta.nr__sordariomyceta.c__Sordariomycetes.o__Sordariales.f__Chaetomiaceae
Chaetothyriomycetidae	sk__Eukaryota.k__Fungi.p__Ascomycota.c__Eurotiomycetes.nr__unclassified_Chaetothyriomycetidae	sk__Eukaryota.nr__Opisthokonta.k__Fungi.p__Ascomycota.nr__saccharomyceta.nr__leotiomyceta.c__Eurotiomycetes.nr__unclassified_Chaetothyriomycetidae
Chiroptera	sk__Eukaryota.k__Metazoa.p__Chordata.c__Mammalia.o__Chiroptera	sk__Eukaryota.nr__Opisthokonta.k__Metazoa.nr__Eumetazoa.nr__Bilateria.nr__Deuterostomia.p__Chordata.nr__Vertebrata.nr__Gnathostomata.nr__Teleostomi.nr__Euteleostomi.sc__Sarcopterygii.nr__Dipnotetrapodomorpha.nr__Tetrapoda.nr__Amniota.c__Mammalia.nr__Theria.nr__Eutheria.nr__Boreoeutheria.so__Laurasiatheria.o__Chiroptera
Chlamydiae	sk__Bacteria.p__Chlamydiae	sk__Bacteria.nr__PVC_group.p__Chlamydiae
Chlorobi	sk__Bacteria.p__Chlorobi	sk__Bacteria.nr__FCB_group.nr__Bacteroidetes/Chlorobi_group.p__Chlorobi
Chloroflexi	sk__Bacteria.p__Chloroflexi	sk__Bacteria.nr__Terrabacteria_group.p__Chloroflexi
Chloroflexia	sk__Bacteria.p__Chloroflexi.c__Chloroflexia	sk__Bacteria.nr__Terrabacteria_group.p__Chloroflexi.c__Chloroflexia
Chlorophyta	sk__Eukaryota.k__Viridiplantae.p__Chlorophyta	sk__Eukaryota.k__Viridiplantae.p__Chlorophyta
Chordata	sk__Eukaryota.k__Metazoa.p__Chordata	sk__Eukaryota.nr__Opisthokonta.k__Metazoa.nr__Eumetazoa.nr__Bilateria.nr__Deuterostomia.p__Chordata
Chromadorea	sk__Eukaryota.k__Metazoa.p__Nematoda.c__Chromadorea	sk__Eukaryota.nr__Opisthokonta.k__Metazoa.nr__Eumetazoa.nr__Bilateria.nr__Protostomia.nr__Ecdysozoa.p__Nematoda.c__Chromadorea
Chromatiales	sk__Bacteria.p__Proteobacteria.c__Gammaproteobacteria.o__Chromatiales	sk__Bacteria.p__Proteobacteria.c__Gammaproteobacteria.o__Chromatiales
Chryseobacterium	sk__Bacteria.p__Bacteroidetes.c__Flavobacteriia.o__Flavobacteriales.f__Flavobacteriaceae.g__Chryseobacterium	sk__Bacteria.nr__FCB_group.nr__Bacteroidetes/Chlorobi_group.p__Bacteroidetes.c__Flavobacteriia.o__Flavobacteriales.f__Flavobacteriaceae.g__Chryseobacterium
Ciliophora	sk__Eukaryota.p__Ciliophora	sk__Eukaryota.nr__Sar.nr__Alveolata.p__Ciliophora
Citrobacter	sk__Bacteria.p__Proteobacteria.c__Gammaproteobacteria.o__Enterobacterales.f__Enterobacteriaceae.g__Citrobacter	sk__Bacteria.p__Proteobacteria.c__Gammaproteobacteria.o__Enterobacterales.f__Enterobacteriaceae.g__Citrobacter
Clavicipitaceae	sk__Eukaryota.k__Fungi.p__Ascomycota.c__Sordariomycetes.o__Hypocreales.f__Clavicipitaceae	sk__Eukaryota.nr__Opisthokonta.k__Fungi.p__Ascomycota.nr__saccharomyceta.nr__leotiomyceta.nr__sordariomyceta.c__Sordariomycetes.o__Hypocreales.f__Clavicipitaceae
Clostridia	sk__Bacteria.p__Firmicutes.c__Clostridia	sk__Bacteria.nr__Terrabacteria_group.p__Firmicutes.c__Clostridia
Clostridiaceae	sk__Bacteria.p__Firmicutes.c__Clostridia.o__Clostridiales.f__Clostridiaceae	sk__Bacteria.nr__Terrabacteria_group.p__Firmicutes.c__Clostridia.o__Clostridiales.f__Clostridiaceae
Clostridiales incertae sedis	sk__Bacteria.p__Firmicutes.c__Clostridia.o__Clostridiales.nr__Clostridiales_incertae_sedis	sk__Bacteria.nr__Terrabacteria_group.p__Firmicutes.c__Clostridia.o__Clostridiales.nr__Clostridiales_incertae_sedis
Coccidia	sk__Eukaryota.p__Apicomplexa.c__Conoidasida.nr__unclassified_Coccidia	sk__Eukaryota.nr__Sar.nr__Alveolata.p__Apicomplexa.c__Conoidasida.nr__unclassified_Coccidia
Colwelliaceae	sk__Bacteria.p__Proteobacteria.c__Gammaproteobacteria.o__Alteromonadales.f__Colwelliaceae	sk__Bacteria.p__Proteobacteria.c__Gammaproteobacteria.o__Alteromonadales.f__Colwelliaceae
Comamonadaceae	sk__Bacteria.p__Proteobacteria.c__Betaproteobacteria.o__Burkholderiales.f__Comamonadaceae	sk__Bacteria.p__Proteobacteria.c__Betaproteobacteria.o__Burkholderiales.f__Comamonadaceae
Coriobacteriia	sk__Bacteria.p__Actinobacteria.c__Coriobacteriia	sk__Bacteria.nr__Terrabacteria_group.p__Actinobacteria.c__Coriobacteriia
Corynebacteriaceae	sk__Bacteria.p__Actinobacteria.c__Actinobacteria.o__Corynebacteriales.f__Corynebacteriaceae	sk__Bacteria.nr__Terrabacteria_group.p__Actinobacteria.c__Actinobacteria.o__Corynebacteriales.f__Corynebacteriaceae
Crenarchaeota	sk__Archaea.p__Crenarchaeota	sk__Archaea.nr__TACK_group.p__Crenarchaeota
Cryomorphaceae	sk__Bacteria.p__Bacteroidetes.c__Flavobacteriia.o__Flavobacteriales.f__Cryomorphaceae	sk__Bacteria.nr__FCB_group.nr__Bacteroidetes/Chlorobi_group.p__Bacteroidetes.c__Flavobacteriia.o__Flavobacteriales.f__Cryomorphaceae
Cyanobacteria	sk__Bacteria.p__Cyanobacteria	sk__Bacteria.nr__Terrabacteria_group.nr__Cyanobacteria/Melainabacteria_group.p__Cyanobacteria
Cyanobium	sk__Bacteria.p__Cyanobacteria.o__Synechococcales.f__Synechococcaceae.g__Cyanobium	sk__Bacteria.nr__Terrabacteria_group.nr__Cyanobacteria/Melainabacteria_group.p__Cyanobacteria.o__Synechococcales.f__Synechococcaceae.g__Cyanobium
Cyanothece	sk__Bacteria.p__Cyanobacteria.o__Oscillatoriales.f__Cyanothecaceae.g__Cyanothece	sk__Bacteria.nr__Terrabacteria_group.nr__Cyanobacteria/Melainabacteria_group.p__Cyanobacteria.o__Oscillatoriales.f__Cyanothecaceae.g__Cyanothece
Cytophagia	sk__Bacteria.p__Bacteroidetes.c__Cytophagia	sk__Bacteria.nr__FCB_group.nr__Bacteroidetes/Chlorobi_group.p__Bacteroidetes.c__Cytophagia
Debaryomycetaceae	sk__Eukaryota.k__Fungi.p__Ascomycota.c__Saccharomycetes.o__Saccharomycetales.f__Debaryomycetaceae	sk__Eukaryota.nr__Opisthokonta.k__Fungi.p__Ascomycota.nr__saccharomyceta.c__Saccharomycetes.o__Saccharomycetales.f__Debaryomycetaceae
Deferribacteres	sk__Bacteria.p__Deferribacteres.c__Deferribacteres	sk__Bacteria.p__Deferribacteres.c__Deferribacteres
Dehalococcoidia	sk__Bacteria.p__Chloroflexi.c__Dehalococcoidia	sk__Bacteria.nr__Terrabacteria_group.p__Chloroflexi.c__Dehalococcoidia
Deinococcus-Thermus	sk__Bacteria.p__Deinococcus-Thermus	sk__Bacteria.nr__Terrabacteria_group.p__Deinococcus-Thermus
delta/epsilon subdivisions	sk__Bacteria.p__Proteobacteria	sk__Bacteria.p__Proteobacteria
Deltaproteobacteria	sk__Bacteria.p__Proteobacteria.c__Deltaproteobacteria	sk__Bacteria.p__Proteobacteria.c__Deltaproteobacteria
Dermabacteraceae	sk__Bacteria.p__Actinobacteria.c__Actinobacteria.o__Micrococcales.f__Dermabacteraceae	sk__Bacteria.nr__Terrabacteria_group.p__Actinobacteria.c__Actinobacteria.o__Micrococcales.f__Dermabacteraceae
Dermacoccaceae	sk__Bacteria.p__Actinobacteria.c__Actinobacteria.o__Micrococcales.f__Dermacoccaceae	sk__Bacteria.nr__Terrabacteria_group.p__Actinobacteria.c__Actinobacteria.o__Micrococcales.f__Dermacoccaceae
Dermatophilaceae	sk__Bacteria.p__Actinobacteria.c__Actinobacteria.o__Micrococcales.f__Dermatophilaceae	sk__Bacteria.nr__Terrabacteria_group.p__Actinobacteria.c__Actinobacteria.o__Micrococcales.f__Dermatophilaceae
Desulfobacterales	sk__Bacteria.p__Proteobacteria.c__Deltaproteobacteria.o__Desulfobacterales	sk__Bacteria.p__Proteobacteria.c__Deltaproteobacteria.o__Desulfobacterales
Desulfovibrionales	sk__Bacteria.p__Proteobacteria.c__Deltaproteobacteria.o__Desulfovibrionales	sk__Bacteria.p__Proteobacteria.c__Deltaproteobacteria.o__Desulfovibrionales
Desulfurellales	sk__Bacteria.p__Proteobacteria.c__Deltaproteobacteria.o__Desulfurellales	sk__Bacteria.p__Proteobacteria.c__Deltaproteobacteria.o__Desulfurellales
Desulfuromonadales	sk__Bacteria.p__Proteobacteria.c__Deltaproteobacteria.o__Desulfuromonadales	sk__Bacteria.p__Proteobacteria.c__Deltaproteobacteria.o__Desulfuromonadales
Dickeya	sk__Bacteria.p__Proteobacteria.c__Gammaproteobacteria.o__Enterobacterales.f__Pectobacteriaceae.g__Dickeya	sk__Bacteria.p__Proteobacteria.c__Gammaproteobacteria.o__Enterobacterales.f__Pectobacteriaceae.g__Dickeya
Diptera	sk__Eukaryota.k__Metazoa.p__Arthropoda.c__Insecta.o__Diptera	sk__Eukaryota.nr__Opisthokonta.k__Metazoa.nr__Eumetazoa.nr__Bilateria.nr__Protostomia.nr__Ecdysozoa.nr__Panarthropoda.p__Arthropoda.nr__Mandibulata.nr__Pancrustacea.c__Insecta.nr__Dicondylia.o__Diptera
Dokdonia	sk__Bacteria.p__Bacteroidetes.c__Flavobacteriia.o__Flavobacteriales.f__Flavobacteriaceae.g__Dokdonia	sk__Bacteria.nr__FCB_group.nr__Bacteroidetes/Chlorobi_group.p__Bacteroidetes.c__Flavobacteriia.o__Flavobacteriales.f__Flavobacteriaceae.g__Dokdonia
Dorea	sk__Bacteria.p__Firmicutes.c__Clostridia.o__Clostridiales.f__Lachnospiraceae.g__Dorea	sk__Bacteria.nr__Terrabacteria_group.p__Firmicutes.c__Clostridia.o__Clostridiales.f__Lachnospiraceae.g__Dorea
Dothideomycetes	sk__Eukaryota.k__Fungi.p__Ascomycota.c__Dothideomycetes	sk__Eukaryota.nr__Opisthokonta.k__Fungi.p__Ascomycota.nr__saccharomyceta.nr__leotiomyceta.nr__dothideomyceta.c__Dothideomycetes
Dothideomycetidae	sk__Eukaryota.k__Fungi.p__Ascomycota.c__Dothideomycetes.nr__unclassified_Dothideomycetidae	sk__Eukaryota.nr__Opisthokonta.k__Fungi.p__Ascomycota.nr__saccharomyceta.nr__leotiomyceta.nr__dothideomyceta.c__Dothideomycetes.nr__unclassified_Dothideomycetidae
Drosophilidae	sk__Eukaryota.k__Metazoa.p__Arthropoda.c__Insecta.o__Diptera.f__Drosophilidae	sk__Eukaryota.nr__Opisthokonta.k__Metazoa.nr__Eumetazoa.nr__Bilateria.nr__Protostomia.nr__Ecdysozoa.nr__Panarthropoda.p__Arthropoda.nr__Mandibulata.nr__Pancrustacea.c__Insecta.nr__Dicondylia.o__Diptera.nr__Eremoneura.nr__Cyclorrhapha.nr__Schizophora.nr__Acalyptratae.sf__Ephydroidea.f__Drosophilidae
dsDNA viruses, no RNA stage	sk__Viruses.nr__unclassified_dsDNA_viruses	sk__Viruses.nr__unclassified_viruses.nr__unclassified_DNA_viruses.nr__unclassified_dsDNA_viruses
Elizabethkingia	sk__Bacteria.p__Bacteroidetes.c__Flavobacteriia.o__Flavobacteriales.f__Flavobacteriaceae.g__Elizabethkingia	sk__Bacteria.nr__FCB_group.nr__Bacteroidetes/Chlorobi_group.p__Bacteroidetes.c__Flavobacteriia.o__Flavobacteriales.f__Flavobacteriaceae.g__Elizabethkingia
Enterobacter	sk__Bacteria.p__Proteobacteria.c__Gammaproteobacteria.o__Enterobacterales.f__Enterobacteriaceae.g__Enterobacter	sk__Bacteria.p__Proteobacteria.c__Gammaproteobacteria.o__Enterobacterales.f__Enterobacteriaceae.g__Enterobacter
Enterococcaceae	sk__Bacteria.p__Firmicutes.c__Bacilli.o__Lactobacillales.f__Enterococcaceae	sk__Bacteria.nr__Terrabacteria_group.p__Firmicutes.c__Bacilli.o__Lactobacillales.f__Enterococcaceae
Epsilonproteobacteria	sk__Bacteria.p__Proteobacteria.c__Epsilonproteobacteria	sk__Bacteria.p__Proteobacteria.c__Epsilonproteobacteria
Erwinia	sk__Bacteria.p__Proteobacteria.c__Gammaproteobacteria.o__Enterobacterales.f__Erwiniaceae.g__Erwinia	sk__Bacteria.p__Proteobacteria.c__Gammaproteobacteria.o__Enterobacterales.f__Erwiniaceae.g__Erwinia
Erysipelotrichia	sk__Bacteria.p__Firmicutes.c__Erysipelotrichia	sk__Bacteria.nr__Terrabacteria_group.p__Firmicutes.c__Erysipelotrichia
Escherichia	sk__Bacteria.p__Proteobacteria.c__Gammaproteobacteria.o__Enterobacterales.f__Enterobacteriaceae.g__Escherichia	sk__Bacteria.p__Proteobacteria.c__Gammaproteobacteria.o__Enterobacterales.f__Enterobacteriaceae.g__Escherichia
Euarchontoglires	sk__Eukaryota.k__Metazoa.p__Chordata.c__Mammalia.so__Euarchontoglires	sk__Eukaryota.nr__Opisthokonta.k__Metazoa.nr__Eumetazoa.nr__Bilateria.nr__Deuterostomia.p__Chordata.nr__Vertebrata.nr__Gnathostomata.nr__Teleostomi.nr__Euteleostomi.sc__Sarcopterygii.nr__Dipnotetrapodomorpha.nr__Tetrapoda.nr__Amniota.c__Mammalia.nr__Theria.nr__Eutheria.nr__Boreoeutheria.so__Euarchontoglires
Eubacteriaceae	sk__Bacteria.p__Firmicutes.c__Clostridia.o__Clostridiales.f__Eubacteriaceae	sk__Bacteria.nr__Terrabacteria_group.p__Firmicutes.c__Clostridia.o__Clostridiales.f__Eubacteriaceae
Eukaryota	sk__Eukaryota	sk__Eukaryota
Eurotiales	sk__Eukaryota.k__Fungi.p__Ascomycota.c__Eurotiomycetes.o__Eurotiales	sk__Eukaryota.nr__Opisthokonta.k__Fungi.p__Ascomycota.nr__saccharomyceta.nr__leotiomyceta.c__Eurotiomycetes.o__Eurotiales
Eurotiomycetes	sk__Eukaryota.k__Fungi.p__Ascomycota.c__Eurotiomycetes	sk__Eukaryota.nr__Opisthokonta.k__Fungi.p__Ascomycota.nr__saccharomyceta.nr__leotiomyceta.c__Eurotiomycetes
Euryarchaeota	sk__Archaea.p__Euryarchaeota	sk__Archaea.p__Euryarchaeota
fabids	sk__Eukaryota.k__Viridiplantae.p__Streptophyta.c__Magnoliopsida.nr__fabids	sk__Eukaryota.k__Viridiplantae.p__Streptophyta.nr__Embryophyta.nr__Tracheophyta.nr__Euphyllophyta.nr__Spermatophyta.c__Magnoliopsida.nr__Mesangiospermae.nr__eudicotyledons.nr__Gunneridae.nr__Pentapetalae.nr__rosids.nr__fabids
Firmicutes	sk__Bacteria.p__Firmicutes	sk__Bacteria.nr__Terrabacteria_group.p__Firmicutes
Flavobacteriia	sk__Bacteria.p__Bacteroidetes.c__Flavobacteriia	sk__Bacteria.nr__FCB_group.nr__Bacteroidetes/Chlorobi_group.p__Bacteroidetes.c__Flavobacteriia
Flavobacterium	sk__Bacteria.p__Bacteroidetes.c__Flavobacteriia.o__Flavobacteriales.f__Flavobacteriaceae.g__Flavobacterium	sk__Bacteria.nr__FCB_group.nr__Bacteroidetes/Chlorobi_group.p__Bacteroidetes.c__Flavobacteriia.o__Flavobacteriales.f__Flavobacteriaceae.g__Flavobacterium
Frankiales	sk__Bacteria.p__Actinobacteria.c__Actinobacteria.o__Frankiales	sk__Bacteria.nr__Terrabacteria_group.p__Actinobacteria.c__Actinobacteria.o__Frankiales
Fungi	sk__Eukaryota.k__Fungi	sk__Eukaryota.nr__Opisthokonta.k__Fungi
Fungi incertae sedis	sk__Eukaryota.k__Fungi.nr__Fungi_incertae_sedis	sk__Eukaryota.nr__Opisthokonta.k__Fungi.nr__Fungi_incertae_sedis
Fusobacteria	sk__Bacteria.p__Fusobacteria	sk__Bacteria.p__Fusobacteria
Gammaproteobacteria	sk__Bacteria.p__Proteobacteria.c__Gammaproteobacteria	sk__Bacteria.p__Proteobacteria.c__Gammaproteobacteria
Gemmatimonadetes	sk__Bacteria.p__Gemmatimonadetes	sk__Bacteria.nr__FCB_group.p__Gemmatimonadetes
Geobacillus	sk__Bacteria.p__Firmicutes.c__Bacilli.o__Bacillales.f__Bacillaceae.g__Geobacillus	sk__Bacteria.nr__Terrabacteria_group.p__Firmicutes.c__Bacilli.o__Bacillales.f__Bacillaceae.g__Geobacillus
Gillisia	sk__Bacteria.p__Bacteroidetes.c__Flavobacteriia.o__Flavobacteriales.f__Flavobacteriaceae.g__Gillisia	sk__Bacteria.nr__FCB_group.nr__Bacteroidetes/Chlorobi_group.p__Bacteroidetes.c__Flavobacteriia.o__Flavobacteriales.f__Flavobacteriaceae.g__Gillisia
Glomerellales	sk__Eukaryota.k__Fungi.p__Ascomycota.c__Sordariomycetes.o__Glomerellales	sk__Eukaryota.nr__Opisthokonta.k__Fungi.p__Ascomycota.nr__saccharomyceta.nr__leotiomyceta.nr__sordariomyceta.c__Sordariomycetes.o__Glomerellales
Glycomycetales	sk__Bacteria.p__Actinobacteria.c__Actinobacteria.o__Glycomycetales	sk__Bacteria.nr__Terrabacteria_group.p__Actinobacteria.c__Actinobacteria.o__Glycomycetales
Gordoniaceae	sk__Bacteria.p__Actinobacteria.c__Actinobacteria.o__Corynebacteriales.f__Gordoniaceae	sk__Bacteria.nr__Terrabacteria_group.p__Actinobacteria.c__Actinobacteria.o__Corynebacteriales.f__Gordoniaceae
Gracilibacillus	sk__Bacteria.p__Firmicutes.c__Bacilli.o__Bacillales.f__Bacillaceae.g__Gracilibacillus	sk__Bacteria.nr__Terrabacteria_group.p__Firmicutes.c__Bacilli.o__Bacillales.f__Bacillaceae.g__Gracilibacillus
Haemosporida	sk__Eukaryota.p__Apicomplexa.c__Aconoidasida.o__Haemosporida	sk__Eukaryota.nr__Sar.nr__Alveolata.p__Apicomplexa.c__Aconoidasida.o__Haemosporida
Halanaerobiales	sk__Bacteria.p__Firmicutes.c__Clostridia.o__Halanaerobiales	sk__Bacteria.nr__Terrabacteria_group.p__Firmicutes.c__Clostridia.o__Halanaerobiales
Halobacillus	sk__Bacteria.p__Firmicutes.c__Bacilli.o__Bacillales.f__Bacillaceae.g__Halobacillus	sk__Bacteria.nr__Terrabacteria_group.p__Firmicutes.c__Bacilli.o__Bacillales.f__Bacillaceae.g__Halobacillus
Halobacteria	sk__Archaea.p__Euryarchaeota.c__Halobacteria	sk__Archaea.p__Euryarchaeota.nr__Stenosarchaea_group.c__Halobacteria
Hepadnaviridae	sk__Viruses.f__Hepadnaviridae	sk__Viruses.f__Hepadnaviridae
Hominidae	sk__Eukaryota.k__Metazoa.p__Chordata.c__Mammalia.o__Primates.f__Hominidae	sk__Eukaryota.nr__Opisthokonta.k__Metazoa.nr__Eumetazoa.nr__Bilateria.nr__Deuterostomia.p__Chordata.nr__Vertebrata.nr__Gnathostomata.nr__Teleostomi.nr__Euteleostomi.sc__Sarcopterygii.nr__Dipnotetrapodomorpha.nr__Tetrapoda.nr__Amniota.c__Mammalia.nr__Theria.nr__Eutheria.nr__Boreoeutheria.so__Euarchontoglires.o__Primates.sf__Hominoidea.f__Hominidae
Hydrogenophilales	sk__Bacteria.p__Proteobacteria.c__Hydrogenophilalia.o__Hydrogenophilales	sk__Bacteria.p__Proteobacteria.c__Hydrogenophilalia.o__Hydrogenophilales
Hymenoptera	sk__Eukaryota.k__Metazoa.p__Arthropoda.c__Insecta.o__Hymenoptera	sk__Eukaryota.nr__Opisthokonta.k__Metazoa.nr__Eumetazoa.nr__Bilateria.nr__Protostomia.nr__Ecdysozoa.nr__Panarthropoda.p__Arthropoda.nr__Mandibulata.nr__Pancrustacea.c__Insecta.nr__Dicondylia.o__Hymenoptera
Hyphomicrobiaceae	sk__Bacteria.p__Proteobacteria.c__Alphaproteobacteria.o__Rhizobiales.f__Hyphomicrobiaceae	sk__Bacteria.p__Proteobacteria.c__Alphaproteobacteria.o__Rhizobiales.f__Hyphomicrobiaceae
Hyphomonadaceae	sk__Bacteria.p__Proteobacteria.c__Alphaproteobacteria.o__Rhodobacterales.f__Hyphomonadaceae	sk__Bacteria.p__Proteobacteria.c__Alphaproteobacteria.o__Rhodobacterales.f__Hyphomonadaceae
Hypocreaceae	sk__Eukaryota.k__Fungi.p__Ascomycota.c__Sordariomycetes.o__Hypocreales.f__Hypocreaceae	sk__Eukaryota.nr__Opisthokonta.k__Fungi.p__Ascomycota.nr__saccharomyceta.nr__leotiomyceta.nr__sordariomyceta.c__Sordariomycetes.o__Hypocreales.f__Hypocreaceae
Hypocreales	sk__Eukaryota.k__Fungi.p__Ascomycota.c__Sordariomycetes.o__Hypocreales	sk__Eukaryota.nr__Opisthokonta.k__Fungi.p__Ascomycota.nr__saccharomyceta.nr__leotiomyceta.nr__sordariomyceta.c__Sordariomycetes.o__Hypocreales
Idiomarinaceae	sk__Bacteria.p__Proteobacteria.c__Gammaproteobacteria.o__Alteromonadales.f__Idiomarinaceae	sk__Bacteria.p__Proteobacteria.c__Gammaproteobacteria.o__Alteromonadales.f__Idiomarinaceae
Inoviridae	sk__Viruses.f__Inoviridae	sk__Viruses.f__Inoviridae
Insecta	sk__Eukaryota.k__Metazoa.p__Arthropoda.c__Insecta	sk__Eukaryota.nr__Opisthokonta.k__Metazoa.nr__Eumetazoa.nr__Bilateria.nr__Protostomia.nr__Ecdysozoa.nr__Panarthropoda.p__Arthropoda.nr__Mandibulata.nr__Pancrustacea.c__Insecta
Intrasporangiaceae	sk__Bacteria.p__Actinobacteria.c__Actinobacteria.o__Micrococcales.f__Intrasporangiaceae	sk__Bacteria.nr__Terrabacteria_group.p__Actinobacteria.c__Actinobacteria.o__Micrococcales.f__Intrasporangiaceae
Kinetoplastida	sk__Eukaryota.p__Euglenozoa.c__Kinetoplastea.nr__unclassified_Kinetoplastida	sk__Eukaryota.p__Euglenozoa.c__Kinetoplastea.nr__unclassified_Kinetoplastida
Kitasatospora	sk__Bacteria.p__Actinobacteria.c__Actinobacteria.o__Streptomycetales.f__Streptomycetaceae.g__Kitasatospora	sk__Bacteria.nr__Terrabacteria_group.p__Actinobacteria.c__Actinobacteria.o__Streptomycetales.f__Streptomycetaceae.g__Kitasatospora
Lachnoanaerobaculum	sk__Bacteria.p__Firmicutes.c__Clostridia.o__Clostridiales.f__Lachnospiraceae.g__Lachnoanaerobaculum	sk__Bacteria.nr__Terrabacteria_group.p__Firmicutes.c__Clostridia.o__Clostridiales.f__Lachnospiraceae.g__Lachnoanaerobaculum
Lachnoclostridium	sk__Bacteria.p__Firmicutes.c__Clostridia.o__Clostridiales.f__Lachnospiraceae.g__Lachnoclostridium	sk__Bacteria.nr__Terrabacteria_group.p__Firmicutes.c__Clostridia.o__Clostridiales.f__Lachnospiraceae.g__Lachnoclostridium
Lactobacillaceae	sk__Bacteria.p__Firmicutes.c__Bacilli.o__Lactobacillales.f__Lactobacillaceae	sk__Bacteria.nr__Terrabacteria_group.p__Firmicutes.c__Bacilli.o__Lactobacillales.f__Lactobacillaceae
Lactococcus	sk__Bacteria.p__Firmicutes.c__Bacilli.o__Lactobacillales.f__Streptococcaceae.g__Lactococcus	sk__Bacteria.nr__Terrabacteria_group.p__Firmicutes.c__Bacilli.o__Lactobacillales.f__Streptococcaceae.g__Lactococcus
Leeuwenhoekiella	sk__Bacteria.p__Bacteroidetes.c__Flavobacteriia.o__Flavobacteriales.f__Flavobacteriaceae.g__Leeuwenhoekiella	sk__Bacteria.nr__FCB_group.nr__Bacteroidetes/Chlorobi_group.p__Bacteroidetes.c__Flavobacteriia.o__Flavobacteriales.f__Flavobacteriaceae.g__Leeuwenhoekiella
Legionellales	sk__Bacteria.p__Proteobacteria.c__Gammaproteobacteria.o__Legionellales	sk__Bacteria.p__Proteobacteria.c__Gammaproteobacteria.o__Legionellales
Leisingera	sk__Bacteria.p__Proteobacteria.c__Alphaproteobacteria.o__Rhodobacterales.f__Rhodobacteraceae.g__Leisingera	sk__Bacteria.p__Proteobacteria.c__Alphaproteobacteria.o__Rhodobacterales.f__Rhodobacteraceae.g__Leisingera
Leotiomycetes	sk__Eukaryota.k__Fungi.p__Ascomycota.c__Leotiomycetes	sk__Eukaryota.nr__Opisthokonta.k__Fungi.p__Ascomycota.nr__saccharomyceta.nr__leotiomyceta.nr__sordariomyceta.c__Leotiomycetes
Lepidoptera	sk__Eukaryota.k__Metazoa.p__Arthropoda.c__Insecta.o__Lepidoptera	sk__Eukaryota.nr__Opisthokonta.k__Metazoa.nr__Eumetazoa.nr__Bilateria.nr__Protostomia.nr__Ecdysozoa.nr__Panarthropoda.p__Arthropoda.nr__Mandibulata.nr__Pancrustacea.c__Insecta.nr__Dicondylia.so__Amphiesmenoptera.o__Lepidoptera
Leuconostocaceae	sk__Bacteria.p__Firmicutes.c__Bacilli.o__Lactobacillales.f__Leuconostocaceae	sk__Bacteria.nr__Terrabacteria_group.p__Firmicutes.c__Bacilli.o__Lactobacillales.f__Leuconostocaceae
Liliopsida	sk__Eukaryota.k__Viridiplantae.p__Streptophyta.c__Magnoliopsida.nr__Liliopsida	sk__Eukaryota.k__Viridiplantae.p__Streptophyta.nr__Embryophyta.nr__Tracheophyta.nr__Euphyllophyta.nr__Spermatophyta.c__Magnoliopsida.nr__Mesangiospermae.nr__Liliopsida
Listeriaceae	sk__Bacteria.p__Firmicutes.c__Bacilli.o__Bacillales.f__Listeriaceae	sk__Bacteria.nr__Terrabacteria_group.p__Firmicutes.c__Bacilli.o__Bacillales.f__Listeriaceae
Loktanella	sk__Bacteria.p__Proteobacteria.c__Alphaproteobacteria.o__Rhodobacterales.f__Rhodobacteraceae.g__Loktanella	sk__Bacteria.p__Proteobacteria.c__Alphaproteobacteria.o__Rhodobacterales.f__Rhodobacteraceae.g__Loktanella
Lysinibacillus	sk__Bacteria.p__Firmicutes.c__Bacilli.o__Bacillales.f__Bacillaceae.g__Lysinibacillus	sk__Bacteria.nr__Terrabacteria_group.p__Firmicutes.c__Bacilli.o__Bacillales.f__Bacillaceae.g__Lysinibacillus
Magnaporthales	sk__Eukaryota.k__Fungi.p__Ascomycota.c__Sordariomycetes.o__Magnaporthales	sk__Eukaryota.nr__Opisthokonta.k__Fungi.p__Ascomycota.nr__saccharomyceta.nr__leotiomyceta.nr__sordariomyceta.c__Sordariomycetes.o__Magnaporthales
Mammalia	sk__Eukaryota.k__Metazoa.p__Chordata.c__Mammalia	sk__Eukaryota.nr__Opisthokonta.k__Metazoa.nr__Eumetazoa.nr__Bilateria.nr__Deuterostomia.p__Chordata.nr__Vertebrata.nr__Gnathostomata.nr__Teleostomi.nr__Euteleostomi.sc__Sarcopterygii.nr__Dipnotetrapodomorpha.nr__Tetrapoda.nr__Amniota.c__Mammalia
Maribacter	sk__Bacteria.p__Bacteroidetes.c__Flavobacteriia.o__Flavobacteriales.f__Flavobacteriaceae.g__Maribacter	sk__Bacteria.nr__FCB_group.nr__Bacteroidetes/Chlorobi_group.p__Bacteroidetes.c__Flavobacteriia.o__Flavobacteriales.f__Flavobacteriaceae.g__Maribacter
Marinilabiliaceae	sk__Bacteria.p__Bacteroidetes.c__Bacteroidia.o__Marinilabiliales.f__Marinilabiliaceae	sk__Bacteria.nr__FCB_group.nr__Bacteroidetes/Chlorobi_group.p__Bacteroidetes.c__Bacteroidia.o__Marinilabiliales.f__Marinilabiliaceae
Metatheria	sk__Eukaryota.k__Metazoa.p__Chordata.c__Mammalia.nr__Metatheria	sk__Eukaryota.nr__Opisthokonta.k__Metazoa.nr__Eumetazoa.nr__Bilateria.nr__Deuterostomia.p__Chordata.nr__Vertebrata.nr__Gnathostomata.nr__Teleostomi.nr__Euteleostomi.sc__Sarcopterygii.nr__Dipnotetrapodomorpha.nr__Tetrapoda.nr__Amniota.c__Mammalia.nr__Theria.nr__Metatheria
Metazoa	sk__Eukaryota.k__Metazoa	sk__Eukaryota.nr__Opisthokonta.k__Metazoa
Methanobacteria	sk__Archaea.p__Euryarchaeota.c__Methanobacteria	sk__Archaea.p__Euryarchaeota.nr__Methanomada_group.c__Methanobacteria
Methanococci	sk__Archaea.p__Euryarchaeota.c__Methanococci	sk__Archaea.p__Euryarchaeota.nr__Methanomada_group.c__Methanococci
Methanomicrobia	sk__Archaea.p__Euryarchaeota.c__Methanomicrobia	sk__Archaea.p__Euryarchaeota.nr__Stenosarchaea_group.c__Methanomicrobia
Methylobacteriaceae	sk__Bacteria.p__Proteobacteria.c__Alphaproteobacteria.o__Rhizobiales.f__Methylobacteriaceae	sk__Bacteria.p__Proteobacteria.c__Alphaproteobacteria.o__Rhizobiales.f__Methylobacteriaceae
Methylococcales	sk__Bacteria.p__Proteobacteria.c__Gammaproteobacteria.o__Methylococcales	sk__Bacteria.p__Proteobacteria.c__Gammaproteobacteria.o__Methylococcales
Methylocystaceae	sk__Bacteria.p__Proteobacteria.c__Alphaproteobacteria.o__Rhizobiales.f__Methylocystaceae	sk__Bacteria.p__Proteobacteria.c__Alphaproteobacteria.o__Rhizobiales.f__Methylocystaceae
Microbacteriaceae	sk__Bacteria.p__Actinobacteria.c__Actinobacteria.o__Micrococcales.f__Microbacteriaceae	sk__Bacteria.nr__Terrabacteria_group.p__Actinobacteria.c__Actinobacteria.o__Micrococcales.f__Microbacteriaceae
Micrococcaceae	sk__Bacteria.p__Actinobacteria.c__Actinobacteria.o__Micrococcales.f__Micrococcaceae	sk__Bacteria.nr__Terrabacteria_group.p__Actinobacteria.c__Actinobacteria.o__Micrococcales.f__Micrococcaceae
Micromonosporales	sk__Bacteria.p__Actinobacteria.c__Actinobacteria.o__Micromonosporales	sk__Bacteria.nr__Terrabacteria_group.p__Actinobacteria.c__Actinobacteria.o__Micromonosporales
Microviridae	sk__Viruses.f__Microviridae	sk__Viruses.f__Microviridae
Mononegavirales	sk__Viruses.p__Negarnaviricota.c__Monjiviricetes.o__Mononegavirales	sk__Viruses.nr__Riboviria.p__Negarnaviricota.c__Monjiviricetes.o__Mononegavirales
Moraxellaceae	sk__Bacteria.p__Proteobacteria.c__Gammaproteobacteria.o__Pseudomonadales.f__Moraxellaceae	sk__Bacteria.p__Proteobacteria.c__Gammaproteobacteria.o__Pseudomonadales.f__Moraxellaceae
Mycobacteriaceae	sk__Bacteria.p__Actinobacteria.c__Actinobacteria.o__Corynebacteriales.f__Mycobacteriaceae	sk__Bacteria.nr__Terrabacteria_group.p__Actinobacteria.c__Actinobacteria.o__Corynebacteriales.f__Mycobacteriaceae
Myoviridae	sk__Viruses.o__Caudovirales.f__Myoviridae	sk__Viruses.o__Caudovirales.f__Myoviridae
Myroides	sk__Bacteria.p__Bacteroidetes.c__Flavobacteriia.o__Flavobacteriales.f__Flavobacteriaceae.g__Myroides	sk__Bacteria.nr__FCB_group.nr__Bacteroidetes/Chlorobi_group.p__Bacteroidetes.c__Flavobacteriia.o__Flavobacteriales.f__Flavobacteriaceae.g__Myroides
Myxococcales	sk__Bacteria.p__Proteobacteria.c__Deltaproteobacteria.o__Myxococcales	sk__Bacteria.p__Proteobacteria.c__Deltaproteobacteria.o__Myxococcales
Nectriaceae	sk__Eukaryota.k__Fungi.p__Ascomycota.c__Sordariomycetes.o__Hypocreales.f__Nectriaceae	sk__Eukaryota.nr__Opisthokonta.k__Fungi.p__Ascomycota.nr__saccharomyceta.nr__leotiomyceta.nr__sordariomyceta.c__Sordariomycetes.o__Hypocreales.f__Nectriaceae
Negativicutes	sk__Bacteria.p__Firmicutes.c__Negativicutes	sk__Bacteria.nr__Terrabacteria_group.p__Firmicutes.c__Negativicutes
Neisseriales	sk__Bacteria.p__Proteobacteria.c__Betaproteobacteria.o__Neisseriales	sk__Bacteria.p__Proteobacteria.c__Betaproteobacteria.o__Neisseriales
Nematocera	sk__Eukaryota.k__Metazoa.p__Arthropoda.c__Insecta.o__Diptera.nr__unclassified_Nematocera	sk__Eukaryota.nr__Opisthokonta.k__Metazoa.nr__Eumetazoa.nr__Bilateria.nr__Protostomia.nr__Ecdysozoa.nr__Panarthropoda.p__Arthropoda.nr__Mandibulata.nr__Pancrustacea.c__Insecta.nr__Dicondylia.o__Diptera.nr__unclassified_Nematocera
Nematoda	sk__Eukaryota.k__Metazoa.p__Nematoda	sk__Eukaryota.nr__Opisthokonta.k__Metazoa.nr__Eumetazoa.nr__Bilateria.nr__Protostomia.nr__Ecdysozoa.p__Nematoda
Nidovirales	sk__Viruses.o__Nidovirales	sk__Viruses.nr__Riboviria.o__Nidovirales
Nitrosomonadales	sk__Bacteria.p__Proteobacteria.c__Betaproteobacteria.o__Nitrosomonadales	sk__Bacteria.p__Proteobacteria.c__Betaproteobacteria.o__Nitrosomonadales
Nitrospirae	sk__Bacteria.p__Nitrospirae	sk__Bacteria.p__Nitrospirae
Nocardiaceae	sk__Bacteria.p__Actinobacteria.c__Actinobacteria.o__Corynebacteriales.f__Nocardiaceae	sk__Bacteria.nr__Terrabacteria_group.p__Actinobacteria.c__Actinobacteria.o__Corynebacteriales.f__Nocardiaceae
Nonlabens	sk__Bacteria.p__Bacteroidetes.c__Flavobacteriia.o__Flavobacteriales.f__Flavobacteriaceae.g__Nonlabens	sk__Bacteria.nr__FCB_group.nr__Bacteroidetes/Chlorobi_group.p__Bacteroidetes.c__Flavobacteriia.o__Flavobacteriales.f__Flavobacteriaceae.g__Nonlabens
Nostocales	sk__Bacteria.p__Cyanobacteria.o__Nostocales	sk__Bacteria.nr__Terrabacteria_group.nr__Cyanobacteria/Melainabacteria_group.p__Cyanobacteria.o__Nostocales
Oceanicola	sk__Bacteria.p__Proteobacteria.c__Alphaproteobacteria.o__Rhodobacterales.f__Rhodobacteraceae.g__Oceanicola	sk__Bacteria.p__Proteobacteria.c__Alphaproteobacteria.o__Rhodobacterales.f__Rhodobacteraceae.g__Oceanicola
Oceanobacillus	sk__Bacteria.p__Firmicutes.c__Bacilli.o__Bacillales.f__Bacillaceae.g__Oceanobacillus	sk__Bacteria.nr__Terrabacteria_group.p__Firmicutes.c__Bacilli.o__Bacillales.f__Bacillaceae.g__Oceanobacillus
Oceanospirillales	sk__Bacteria.p__Proteobacteria.c__Gammaproteobacteria.o__Oceanospirillales	sk__Bacteria.p__Proteobacteria.c__Gammaproteobacteria.o__Oceanospirillales
Onygenales	sk__Eukaryota.k__Fungi.p__Ascomycota.c__Eurotiomycetes.o__Onygenales	sk__Eukaryota.nr__Opisthokonta.k__Fungi.p__Ascomycota.nr__saccharomyceta.nr__leotiomyceta.c__Eurotiomycetes.o__Onygenales
Ophiostomatales	sk__Eukaryota.k__Fungi.p__Ascomycota.c__Sordariomycetes.o__Ophiostomatales	sk__Eukaryota.nr__Opisthokonta.k__Fungi.p__Ascomycota.nr__saccharomyceta.nr__leotiomyceta.nr__sordariomyceta.c__Sordariomycetes.o__Ophiostomatales
Opisthokonta	sk__Eukaryota.nr__Opisthokonta	sk__Eukaryota.nr__Opisthokonta
Opitutae	sk__Bacteria.p__Verrucomicrobia.c__Opitutae	sk__Bacteria.nr__PVC_group.p__Verrucomicrobia.c__Opitutae
Oribacterium	sk__Bacteria.p__Firmicutes.c__Clostridia.o__Clostridiales.f__Lachnospiraceae.g__Oribacterium	sk__Bacteria.nr__Terrabacteria_group.p__Firmicutes.c__Clostridia.o__Clostridiales.f__Lachnospiraceae.g__Oribacterium
Oscillatoriales	sk__Bacteria.p__Cyanobacteria.o__Oscillatoriales	sk__Bacteria.nr__Terrabacteria_group.nr__Cyanobacteria/Melainabacteria_group.p__Cyanobacteria.o__Oscillatoriales
Oscillospiraceae	sk__Bacteria.p__Firmicutes.c__Clostridia.o__Clostridiales.f__Oscillospiraceae	sk__Bacteria.nr__Terrabacteria_group.p__Firmicutes.c__Clostridia.o__Clostridiales.f__Oscillospiraceae
Oxalobacteraceae	sk__Bacteria.p__Proteobacteria.c__Betaproteobacteria.o__Burkholderiales.f__Oxalobacteraceae	sk__Bacteria.p__Proteobacteria.c__Betaproteobacteria.o__Burkholderiales.f__Oxalobacteraceae
Paenibacillaceae	sk__Bacteria.p__Firmicutes.c__Bacilli.o__Bacillales.f__Paenibacillaceae	sk__Bacteria.nr__Terrabacteria_group.p__Firmicutes.c__Bacilli.o__Bacillales.f__Paenibacillaceae
Pantoea	sk__Bacteria.p__Proteobacteria.c__Gammaproteobacteria.o__Enterobacterales.f__Erwiniaceae.g__Pantoea	sk__Bacteria.p__Proteobacteria.c__Gammaproteobacteria.o__Enterobacterales.f__Erwiniaceae.g__Pantoea
Paracoccus	sk__Bacteria.p__Proteobacteria.c__Alphaproteobacteria.o__Rhodobacterales.f__Rhodobacteraceae.g__Paracoccus	sk__Bacteria.p__Proteobacteria.c__Alphaproteobacteria.o__Rhodobacterales.f__Rhodobacteraceae.g__Paracoccus
Paraneoptera	sk__Eukaryota.k__Metazoa.p__Arthropoda.c__Insecta.nr__unclassified_Paraneoptera	sk__Eukaryota.nr__Opisthokonta.k__Metazoa.nr__Eumetazoa.nr__Bilateria.nr__Protostomia.nr__Ecdysozoa.nr__Panarthropoda.p__Arthropoda.nr__Mandibulata.nr__Pancrustacea.c__Insecta.nr__Dicondylia.nr__unclassified_Paraneoptera
Pasteurellales	sk__Bacteria.p__Proteobacteria.c__Gammaproteobacteria.o__Pasteurellales	sk__Bacteria.p__Proteobacteria.c__Gammaproteobacteria.o__Pasteurellales
Pectobacterium	sk__Bacteria.p__Proteobacteria.c__Gammaproteobacteria.o__Enterobacterales.f__Pectobacteriaceae.g__Pectobacterium	sk__Bacteria.p__Proteobacteria.c__Gammaproteobacteria.o__Enterobacterales.f__Pectobacteriaceae.g__Pectobacterium
Peptococcaceae	sk__Bacteria.p__Firmicutes.c__Clostridia.o__Clostridiales.f__Peptococcaceae	sk__Bacteria.nr__Terrabacteria_group.p__Firmicutes.c__Clostridia.o__Clostridiales.f__Peptococcaceae
Peptoniphilaceae	sk__Bacteria.p__Firmicutes.c__Tissierellia.o__Tissierellales.f__Peptoniphilaceae	sk__Bacteria.nr__Terrabacteria_group.p__Firmicutes.c__Tissierellia.o__Tissierellales.f__Peptoniphilaceae
Peptostreptococcaceae	sk__Bacteria.p__Firmicutes.c__Clostridia.o__Clostridiales.f__Peptostreptococcaceae	sk__Bacteria.nr__Terrabacteria_group.p__Firmicutes.c__Clostridia.o__Clostridiales.f__Peptostreptococcaceae
Peronosporales	sk__Eukaryota.c__Oomycetes.o__Peronosporales	sk__Eukaryota.nr__Sar.nr__Stramenopiles.c__Oomycetes.o__Peronosporales
Phaeobacter	sk__Bacteria.p__Proteobacteria.c__Alphaproteobacteria.o__Rhodobacterales.f__Rhodobacteraceae.g__Phaeobacter	sk__Bacteria.p__Proteobacteria.c__Alphaproteobacteria.o__Rhodobacterales.f__Rhodobacteraceae.g__Phaeobacter
Phyllobacteriaceae	sk__Bacteria.p__Proteobacteria.c__Alphaproteobacteria.o__Rhizobiales.f__Phyllobacteriaceae	sk__Bacteria.p__Proteobacteria.c__Alphaproteobacteria.o__Rhizobiales.f__Phyllobacteriaceae
Piroplasmida	sk__Eukaryota.p__Apicomplexa.c__Aconoidasida.o__Piroplasmida	sk__Eukaryota.nr__Sar.nr__Alveolata.p__Apicomplexa.c__Aconoidasida.o__Piroplasmida
Planctomycetes	sk__Bacteria.p__Planctomycetes	sk__Bacteria.nr__PVC_group.p__Planctomycetes
Planococcaceae	sk__Bacteria.p__Firmicutes.c__Bacilli.o__Bacillales.f__Planococcaceae	sk__Bacteria.nr__Terrabacteria_group.p__Firmicutes.c__Bacilli.o__Bacillales.f__Planococcaceae
Pleosporales	sk__Eukaryota.k__Fungi.p__Ascomycota.c__Dothideomycetes.o__Pleosporales	sk__Eukaryota.nr__Opisthokonta.k__Fungi.p__Ascomycota.nr__saccharomyceta.nr__leotiomyceta.nr__dothideomyceta.c__Dothideomycetes.o__Pleosporales
Pleurocapsales	sk__Bacteria.p__Cyanobacteria.o__Pleurocapsales	sk__Bacteria.nr__Terrabacteria_group.nr__Cyanobacteria/Melainabacteria_group.p__Cyanobacteria.o__Pleurocapsales
Poales	sk__Eukaryota.k__Viridiplantae.p__Streptophyta.c__Magnoliopsida.o__Poales	sk__Eukaryota.k__Viridiplantae.p__Streptophyta.nr__Embryophyta.nr__Tracheophyta.nr__Euphyllophyta.nr__Spermatophyta.c__Magnoliopsida.nr__Mesangiospermae.nr__Liliopsida.nr__commelinids.o__Poales
Podoviridae	sk__Viruses.o__Caudovirales.f__Podoviridae	sk__Viruses.o__Caudovirales.f__Podoviridae
Polaribacter	sk__Bacteria.p__Bacteroidetes.c__Flavobacteriia.o__Flavobacteriales.f__Flavobacteriaceae.g__Polaribacter	sk__Bacteria.nr__FCB_group.nr__Bacteroidetes/Chlorobi_group.p__Bacteroidetes.c__Flavobacteriia.o__Flavobacteriales.f__Flavobacteriaceae.g__Polaribacter
Pontibacillus	sk__Bacteria.p__Firmicutes.c__Bacilli.o__Bacillales.f__Bacillaceae.g__Pontibacillus	sk__Bacteria.nr__Terrabacteria_group.p__Firmicutes.c__Bacilli.o__Bacillales.f__Bacillaceae.g__Pontibacillus
Porphyromonadaceae	sk__Bacteria.p__Bacteroidetes.c__Bacteroidia.o__Bacteroidales.f__Porphyromonadaceae	sk__Bacteria.nr__FCB_group.nr__Bacteroidetes/Chlorobi_group.p__Bacteroidetes.c__Bacteroidia.o__Bacteroidales.f__Porphyromonadaceae
Primates	sk__Eukaryota.k__Metazoa.p__Chordata.c__Mammalia.o__Primates	sk__Eukaryota.nr__Opisthokonta.k__Metazoa.nr__Eumetazoa.nr__Bilateria.nr__Deuterostomia.p__Chordata.nr__Vertebrata.nr__Gnathostomata.nr__Teleostomi.nr__Euteleostomi.sc__Sarcopterygii.nr__Dipnotetrapodomorpha.nr__Tetrapoda.nr__Amniota.c__Mammalia.nr__Theria.nr__Eutheria.nr__Boreoeutheria.so__Euarchontoglires.o__Primates
Promicromonosporaceae	sk__Bacteria.p__Actinobacteria.c__Actinobacteria.o__Micrococcales.f__Promicromonosporaceae	sk__Bacteria.nr__Terrabacteria_group.p__Actinobacteria.c__Actinobacteria.o__Micrococcales.f__Promicromonosporaceae
Propionibacteriales	sk__Bacteria.p__Actinobacteria.c__Actinobacteria.o__Propionibacteriales	sk__Bacteria.nr__Terrabacteria_group.p__Actinobacteria.c__Actinobacteria.o__Propionibacteriales
Proteobacteria	sk__Bacteria.p__Proteobacteria	sk__Bacteria.p__Proteobacteria
Proteus	sk__Bacteria.p__Proteobacteria.c__Gammaproteobacteria.o__Enterobacterales.f__Morganellaceae.g__Proteus	sk__Bacteria.p__Proteobacteria.c__Gammaproteobacteria.o__Enterobacterales.f__Morganellaceae.g__Proteus
Providencia	sk__Bacteria.p__Proteobacteria.c__Gammaproteobacteria.o__Enterobacterales.f__Morganellaceae.g__Providencia	sk__Bacteria.p__Proteobacteria.c__Gammaproteobacteria.o__Enterobacterales.f__Morganellaceae.g__Providencia
Pseudoalteromonadaceae	sk__Bacteria.p__Proteobacteria.c__Gammaproteobacteria.o__Alteromonadales.f__Pseudoalteromonadaceae	sk__Bacteria.p__Proteobacteria.c__Gammaproteobacteria.o__Alteromonadales.f__Pseudoalteromonadaceae
Pseudobutyrivibrio	sk__Bacteria.p__Firmicutes.c__Clostridia.o__Clostridiales.f__Lachnospiraceae.g__Pseudobutyrivibrio	sk__Bacteria.nr__Terrabacteria_group.p__Firmicutes.c__Clostridia.o__Clostridiales.f__Lachnospiraceae.g__Pseudobutyrivibrio
Pseudomonas aeruginosa group	sk__Bacteria.p__Proteobacteria.c__Gammaproteobacteria.o__Pseudomonadales.f__Pseudomonadaceae.g__Pseudomonas	sk__Bacteria.p__Proteobacteria.c__Gammaproteobacteria.o__Pseudomonadales.f__Pseudomonadaceae.g__Pseudomonas
Pseudomonas fluorescens group	sk__Bacteria.p__Proteobacteria.c__Gammaproteobacteria.o__Pseudomonadales.f__Pseudomonadaceae.g__Pseudomonas	sk__Bacteria.p__Proteobacteria.c__Gammaproteobacteria.o__Pseudomonadales.f__Pseudomonadaceae.g__Pseudomonas
Pseudomonas putida group	sk__Bacteria.p__Proteobacteria.c__Gammaproteobacteria.o__Pseudomonadales.f__Pseudomonadaceae.g__Pseudomonas	sk__Bacteria.p__Proteobacteria.c__Gammaproteobacteria.o__Pseudomonadales.f__Pseudomonadaceae.g__Pseudomonas
Pseudomonas stutzeri group	sk__Bacteria.p__Proteobacteria.c__Gammaproteobacteria.o__Pseudomonadales.f__Pseudomonadaceae.g__Pseudomonas	sk__Bacteria.p__Proteobacteria.c__Gammaproteobacteria.o__Pseudomonadales.f__Pseudomonadaceae.g__Pseudomonas
Pseudomonas syringae group	sk__Bacteria.p__Proteobacteria.c__Gammaproteobacteria.o__Pseudomonadales.f__Pseudomonadaceae.g__Pseudomonas	sk__Bacteria.p__Proteobacteria.c__Gammaproteobacteria.o__Pseudomonadales.f__Pseudomonadaceae.g__Pseudomonas
Pseudonocardiales	sk__Bacteria.p__Actinobacteria.c__Actinobacteria.o__Pseudonocardiales	sk__Bacteria.nr__Terrabacteria_group.p__Actinobacteria.c__Actinobacteria.o__Pseudonocardiales
Psychroflexus	sk__Bacteria.p__Bacteroidetes.c__Flavobacteriia.o__Flavobacteriales.f__Flavobacteriaceae.g__Psychroflexus	sk__Bacteria.nr__FCB_group.nr__Bacteroidetes/Chlorobi_group.p__Bacteroidetes.c__Flavobacteriia.o__Flavobacteriales.f__Flavobacteriaceae.g__Psychroflexus
Psychromonadaceae	sk__Bacteria.p__Proteobacteria.c__Gammaproteobacteria.o__Alteromonadales.f__Psychromonadaceae	sk__Bacteria.p__Proteobacteria.c__Gammaproteobacteria.o__Alteromonadales.f__Psychromonadaceae
Pucciniomycotina	sk__Eukaryota.k__Fungi.p__Basidiomycota.nr__unclassified_Pucciniomycotina	sk__Eukaryota.nr__Opisthokonta.k__Fungi.p__Basidiomycota.nr__unclassified_Pucciniomycotina
Pythiales	sk__Eukaryota.c__Oomycetes.o__Pythiales	sk__Eukaryota.nr__Sar.nr__Stramenopiles.c__Oomycetes.o__Pythiales
Rahnella	sk__Bacteria.p__Proteobacteria.c__Gammaproteobacteria.o__Enterobacterales.f__Yersiniaceae.g__Rahnella	sk__Bacteria.p__Proteobacteria.c__Gammaproteobacteria.o__Enterobacterales.f__Yersiniaceae.g__Rahnella
Retroviridae	sk__Viruses.o__Ortervirales.f__Retroviridae	sk__Viruses.o__Ortervirales.f__Retroviridae
Rhabditida	sk__Eukaryota.k__Metazoa.p__Nematoda.c__Chromadorea.o__Rhabditida	sk__Eukaryota.nr__Opisthokonta.k__Metazoa.nr__Eumetazoa.nr__Bilateria.nr__Protostomia.nr__Ecdysozoa.p__Nematoda.c__Chromadorea.o__Rhabditida
Rhizobiaceae	sk__Bacteria.p__Proteobacteria.c__Alphaproteobacteria.o__Rhizobiales.f__Rhizobiaceae	sk__Bacteria.p__Proteobacteria.c__Alphaproteobacteria.o__Rhizobiales.f__Rhizobiaceae
Rhodobacter	sk__Bacteria.p__Proteobacteria.c__Alphaproteobacteria.o__Rhodobacterales.f__Rhodobacteraceae.g__Rhodobacter	sk__Bacteria.p__Proteobacteria.c__Alphaproteobacteria.o__Rhodobacterales.f__Rhodobacteraceae.g__Rhodobacter
Rhodobiaceae	sk__Bacteria.p__Proteobacteria.c__Alphaproteobacteria.o__Rhizobiales.f__Rhodobiaceae	sk__Bacteria.p__Proteobacteria.c__Alphaproteobacteria.o__Rhizobiales.f__Rhodobiaceae
Rhodocyclales	sk__Bacteria.p__Proteobacteria.c__Betaproteobacteria.o__Rhodocyclales	sk__Bacteria.p__Proteobacteria.c__Betaproteobacteria.o__Rhodocyclales
Rhodospirillales	sk__Bacteria.p__Proteobacteria.c__Alphaproteobacteria.o__Rhodospirillales	sk__Bacteria.p__Proteobacteria.c__Alphaproteobacteria.o__Rhodospirillales
Rhodovulum	sk__Bacteria.p__Proteobacteria.c__Alphaproteobacteria.o__Rhodobacterales.f__Rhodobacteraceae.g__Rhodovulum	sk__Bacteria.p__Proteobacteria.c__Alphaproteobacteria.o__Rhodobacterales.f__Rhodobacteraceae.g__Rhodovulum
Rickettsiales	sk__Bacteria.p__Proteobacteria.c__Alphaproteobacteria.o__Rickettsiales	sk__Bacteria.p__Proteobacteria.c__Alphaproteobacteria.o__Rickettsiales
Rikenellaceae	sk__Bacteria.p__Bacteroidetes.c__Bacteroidia.o__Bacteroidales.f__Rikenellaceae	sk__Bacteria.nr__FCB_group.nr__Bacteroidetes/Chlorobi_group.p__Bacteroidetes.c__Bacteroidia.o__Bacteroidales.f__Rikenellaceae
Rodentia	sk__Eukaryota.k__Metazoa.p__Chordata.c__Mammalia.o__Rodentia	sk__Eukaryota.nr__Opisthokonta.k__Metazoa.nr__Eumetazoa.nr__Bilateria.nr__Deuterostomia.p__Chordata.nr__Vertebrata.nr__Gnathostomata.nr__Teleostomi.nr__Euteleostomi.sc__Sarcopterygii.nr__Dipnotetrapodomorpha.nr__Tetrapoda.nr__Amniota.c__Mammalia.nr__Theria.nr__Eutheria.nr__Boreoeutheria.so__Euarchontoglires.nr__Glires.o__Rodentia
Roseivivax	sk__Bacteria.p__Proteobacteria.c__Alphaproteobacteria.o__Rhodobacterales.f__Rhodobacteraceae.g__Roseivivax	sk__Bacteria.p__Proteobacteria.c__Alphaproteobacteria.o__Rhodobacterales.f__Rhodobacteraceae.g__Roseivivax
Roseobacter	sk__Bacteria.p__Proteobacteria.c__Alphaproteobacteria.o__Rhodobacterales.f__Rhodobacteraceae.g__Roseobacter	sk__Bacteria.p__Proteobacteria.c__Alphaproteobacteria.o__Rhodobacterales.f__Rhodobacteraceae.g__Roseobacter
Roseovarius	sk__Bacteria.p__Proteobacteria.c__Alphaproteobacteria.o__Rhodobacterales.f__Rhodobacteraceae.g__Roseovarius	sk__Bacteria.p__Proteobacteria.c__Alphaproteobacteria.o__Rhodobacterales.f__Rhodobacteraceae.g__Roseovarius
Rubrobacteria	sk__Bacteria.p__Actinobacteria.c__Rubrobacteria	sk__Bacteria.nr__Terrabacteria_group.p__Actinobacteria.c__Rubrobacteria
Ruegeria	sk__Bacteria.p__Proteobacteria.c__Alphaproteobacteria.o__Rhodobacterales.f__Rhodobacteraceae.g__Ruegeria	sk__Bacteria.p__Proteobacteria.c__Alphaproteobacteria.o__Rhodobacterales.f__Rhodobacteraceae.g__Ruegeria
Ruminococcaceae	sk__Bacteria.p__Firmicutes.c__Clostridia.o__Clostridiales.f__Ruminococcaceae	sk__Bacteria.nr__Terrabacteria_group.p__Firmicutes.c__Clostridia.o__Clostridiales.f__Ruminococcaceae
Saccharomycetaceae	sk__Eukaryota.k__Fungi.p__Ascomycota.c__Saccharomycetes.o__Saccharomycetales.f__Saccharomycetaceae	sk__Eukaryota.nr__Opisthokonta.k__Fungi.p__Ascomycota.nr__saccharomyceta.c__Saccharomycetes.o__Saccharomycetales.f__Saccharomycetaceae
Saccharomycetes	sk__Eukaryota.k__Fungi.p__Ascomycota.c__Saccharomycetes	sk__Eukaryota.nr__Opisthokonta.k__Fungi.p__Ascomycota.nr__saccharomyceta.c__Saccharomycetes
Salmonella	sk__Bacteria.p__Proteobacteria.c__Gammaproteobacteria.o__Enterobacterales.f__Enterobacteriaceae.g__Salmonella	sk__Bacteria.p__Proteobacteria.c__Gammaproteobacteria.o__Enterobacterales.f__Enterobacteriaceae.g__Salmonella
Sarcocystidae	sk__Eukaryota.p__Apicomplexa.c__Conoidasida.o__Eucoccidiorida.f__Sarcocystidae	sk__Eukaryota.nr__Sar.nr__Alveolata.p__Apicomplexa.c__Conoidasida.o__Eucoccidiorida.f__Sarcocystidae
Serratia	sk__Bacteria.p__Proteobacteria.c__Gammaproteobacteria.o__Enterobacterales.f__Yersiniaceae.g__Serratia	sk__Bacteria.p__Proteobacteria.c__Gammaproteobacteria.o__Enterobacterales.f__Yersiniaceae.g__Serratia
Shewanellaceae	sk__Bacteria.p__Proteobacteria.c__Gammaproteobacteria.o__Alteromonadales.f__Shewanellaceae	sk__Bacteria.p__Proteobacteria.c__Gammaproteobacteria.o__Alteromonadales.f__Shewanellaceae
Siphoviridae	sk__Viruses.o__Caudovirales.f__Siphoviridae	sk__Viruses.o__Caudovirales.f__Siphoviridae
Sordariaceae	sk__Eukaryota.k__Fungi.p__Ascomycota.c__Sordariomycetes.o__Sordariales.f__Sordariaceae	sk__Eukaryota.nr__Opisthokonta.k__Fungi.p__Ascomycota.nr__saccharomyceta.nr__leotiomyceta.nr__sordariomyceta.c__Sordariomycetes.o__Sordariales.f__Sordariaceae
Sordariales	sk__Eukaryota.k__Fungi.p__Ascomycota.c__Sordariomycetes.o__Sordariales	sk__Eukaryota.nr__Opisthokonta.k__Fungi.p__Ascomycota.nr__saccharomyceta.nr__leotiomyceta.nr__sordariomyceta.c__Sordariomycetes.o__Sordariales
Sordariomycetes	sk__Eukaryota.k__Fungi.p__Ascomycota.c__Sordariomycetes	sk__Eukaryota.nr__Opisthokonta.k__Fungi.p__Ascomycota.nr__saccharomyceta.nr__leotiomyceta.nr__sordariomyceta.c__Sordariomycetes
Sphingobacteriia	sk__Bacteria.p__Bacteroidetes.c__Sphingobacteriia	sk__Bacteria.nr__FCB_group.nr__Bacteroidetes/Chlorobi_group.p__Bacteroidetes.c__Sphingobacteriia
Sphingomonadales	sk__Bacteria.p__Proteobacteria.c__Alphaproteobacteria.o__Sphingomonadales	sk__Bacteria.p__Proteobacteria.c__Alphaproteobacteria.o__Sphingomonadales
Spirochaetes	sk__Bacteria.p__Spirochaetes	sk__Bacteria.p__Spirochaetes
Sporolactobacillaceae	sk__Bacteria.p__Firmicutes.c__Bacilli.o__Bacillales.f__Sporolactobacillaceae	sk__Bacteria.nr__Terrabacteria_group.p__Firmicutes.c__Bacilli.o__Bacillales.f__Sporolactobacillaceae
ssDNA viruses	sk__Viruses.nr__unclassified_ssDNA_viruses	sk__Viruses.nr__unclassified_viruses.nr__unclassified_DNA_viruses.nr__unclassified_ssDNA_viruses
ssRNA negative-strand viruses	sk__Viruses.nr__unclassified_ssRNA_viruses	sk__Viruses.nr__Riboviria.nr__unclassified_Riboviria.nr__unclassified_ssRNA_viruses
Staphylococcaceae	sk__Bacteria.p__Firmicutes.c__Bacilli.o__Bacillales.f__Staphylococcaceae	sk__Bacteria.nr__Terrabacteria_group.p__Firmicutes.c__Bacilli.o__Bacillales.f__Staphylococcaceae
Stigonemataceae	sk__Bacteria.p__Cyanobacteria.o__Nostocales.f__Stigonemataceae	sk__Bacteria.nr__Terrabacteria_group.nr__Cyanobacteria/Melainabacteria_group.p__Cyanobacteria.o__Nostocales.f__Stigonemataceae
Streptacidiphilus	sk__Bacteria.p__Actinobacteria.c__Actinobacteria.o__Streptomycetales.f__Streptomycetaceae.g__Streptacidiphilus	sk__Bacteria.nr__Terrabacteria_group.p__Actinobacteria.c__Actinobacteria.o__Streptomycetales.f__Streptomycetaceae.g__Streptacidiphilus
Streptococcus anginosus group	sk__Bacteria.p__Firmicutes.c__Bacilli.o__Lactobacillales.f__Streptococcaceae.g__Streptococcus	sk__Bacteria.nr__Terrabacteria_group.p__Firmicutes.c__Bacilli.o__Lactobacillales.f__Streptococcaceae.g__Streptococcus
Streptococcus dysgalactiae group	sk__Bacteria.p__Firmicutes.c__Bacilli.o__Lactobacillales.f__Streptococcaceae.g__Streptococcus	sk__Bacteria.nr__Terrabacteria_group.p__Firmicutes.c__Bacilli.o__Lactobacillales.f__Streptococcaceae.g__Streptococcus
Streptococcus infantis	sk__Bacteria.p__Firmicutes.c__Bacilli.o__Lactobacillales.f__Streptococcaceae.g__Streptococcus	sk__Bacteria.nr__Terrabacteria_group.p__Firmicutes.c__Bacilli.o__Lactobacillales.f__Streptococcaceae.g__Streptococcus
Streptococcus mitis	sk__Bacteria.p__Firmicutes.c__Bacilli.o__Lactobacillales.f__Streptococcaceae.g__Streptococcus	sk__Bacteria.nr__Terrabacteria_group.p__Firmicutes.c__Bacilli.o__Lactobacillales.f__Streptococcaceae.g__Streptococcus
Streptococcus oralis	sk__Bacteria.p__Firmicutes.c__Bacilli.o__Lactobacillales.f__Streptococcaceae.g__Streptococcus	sk__Bacteria.nr__Terrabacteria_group.p__Firmicutes.c__Bacilli.o__Lactobacillales.f__Streptococcaceae.g__Streptococcus
Streptococcus pneumoniae	sk__Bacteria.p__Firmicutes.c__Bacilli.o__Lactobacillales.f__Streptococcaceae.g__Streptococcus	sk__Bacteria.nr__Terrabacteria_group.p__Firmicutes.c__Bacilli.o__Lactobacillales.f__Streptococcaceae.g__Streptococcus
Streptococcus sanguinis	sk__Bacteria.p__Firmicutes.c__Bacilli.o__Lactobacillales.f__Streptococcaceae.g__Streptococcus	sk__Bacteria.nr__Terrabacteria_group.p__Firmicutes.c__Bacilli.o__Lactobacillales.f__Streptococcaceae.g__Streptococcus
Streptococcus suis	sk__Bacteria.p__Firmicutes.c__Bacilli.o__Lactobacillales.f__Streptococcaceae.g__Streptococcus	sk__Bacteria.nr__Terrabacteria_group.p__Firmicutes.c__Bacilli.o__Lactobacillales.f__Streptococcaceae.g__Streptococcus
Streptomyces griseus group	sk__Bacteria.p__Actinobacteria.c__Actinobacteria.o__Streptomycetales.f__Streptomycetaceae.g__Streptomyces	sk__Bacteria.nr__Terrabacteria_group.p__Actinobacteria.c__Actinobacteria.o__Streptomycetales.f__Streptomycetaceae.g__Streptomyces
Streptophyta	sk__Eukaryota.k__Viridiplantae.p__Streptophyta	sk__Eukaryota.k__Viridiplantae.p__Streptophyta
Streptosporangiales	sk__Bacteria.p__Actinobacteria.c__Actinobacteria.o__Streptosporangiales	sk__Bacteria.nr__Terrabacteria_group.p__Actinobacteria.c__Actinobacteria.o__Streptosporangiales
Sulfitobacter	sk__Bacteria.p__Proteobacteria.c__Alphaproteobacteria.o__Rhodobacterales.f__Rhodobacteraceae.g__Sulfitobacter	sk__Bacteria.p__Proteobacteria.c__Alphaproteobacteria.o__Rhodobacterales.f__Rhodobacteraceae.g__Sulfitobacter
Sutterellaceae	sk__Bacteria.p__Proteobacteria.c__Betaproteobacteria.o__Burkholderiales.f__Sutterellaceae	sk__Bacteria.p__Proteobacteria.c__Betaproteobacteria.o__Burkholderiales.f__Sutterellaceae
Synechococcus	sk__Bacteria.p__Cyanobacteria.o__Synechococcales.f__Synechococcaceae.g__Synechococcus	sk__Bacteria.nr__Terrabacteria_group.nr__Cyanobacteria/Melainabacteria_group.p__Cyanobacteria.o__Synechococcales.f__Synechococcaceae.g__Synechococcus
Synechocystis	sk__Bacteria.p__Cyanobacteria.o__Synechococcales.f__Merismopediaceae.g__Synechocystis	sk__Bacteria.nr__Terrabacteria_group.nr__Cyanobacteria/Melainabacteria_group.p__Cyanobacteria.o__Synechococcales.f__Merismopediaceae.g__Synechocystis
Synergistetes	sk__Bacteria.p__Synergistetes	sk__Bacteria.p__Synergistetes
Syntrophobacterales	sk__Bacteria.p__Proteobacteria.c__Deltaproteobacteria.o__Syntrophobacterales	sk__Bacteria.p__Proteobacteria.c__Deltaproteobacteria.o__Syntrophobacterales
Syntrophomonadaceae	sk__Bacteria.p__Firmicutes.c__Clostridia.o__Clostridiales.f__Syntrophomonadaceae	sk__Bacteria.nr__Terrabacteria_group.p__Firmicutes.c__Clostridia.o__Clostridiales.f__Syntrophomonadaceae
Taphrinomycotina	sk__Eukaryota.k__Fungi.p__Ascomycota.nr__unclassified_Taphrinomycotina	sk__Eukaryota.nr__Opisthokonta.k__Fungi.p__Ascomycota.nr__unclassified_Taphrinomycotina
Tatumella	sk__Bacteria.p__Proteobacteria.c__Gammaproteobacteria.o__Enterobacterales.f__Erwiniaceae.g__Tatumella	sk__Bacteria.p__Proteobacteria.c__Gammaproteobacteria.o__Enterobacterales.f__Erwiniaceae.g__Tatumella
Tectiviridae	sk__Viruses.f__Tectiviridae	sk__Viruses.f__Tectiviridae
Tenericutes	sk__Bacteria.p__Tenericutes	sk__Bacteria.nr__Terrabacteria_group.p__Tenericutes
Testudines	sk__Eukaryota.k__Metazoa.p__Chordata.o__Testudines	sk__Eukaryota.nr__Opisthokonta.k__Metazoa.nr__Eumetazoa.nr__Bilateria.nr__Deuterostomia.p__Chordata.nr__Vertebrata.nr__Gnathostomata.nr__Teleostomi.nr__Euteleostomi.sc__Sarcopterygii.nr__Dipnotetrapodomorpha.nr__Tetrapoda.nr__Amniota.nr__Sauropsida.nr__Sauria.nr__Archelosauria.o__Testudines
Thaumarchaeota	sk__Archaea.p__Thaumarchaeota	sk__Archaea.nr__TACK_group.p__Thaumarchaeota
Thermoactinomycetaceae	sk__Bacteria.p__Firmicutes.c__Bacilli.o__Bacillales.f__Thermoactinomycetaceae	sk__Bacteria.nr__Terrabacteria_group.p__Firmicutes.c__Bacilli.o__Bacillales.f__Thermoactinomycetaceae
Thermoanaerobacterales	sk__Bacteria.p__Firmicutes.c__Clostridia.o__Thermoanaerobacterales	sk__Bacteria.nr__Terrabacteria_group.p__Firmicutes.c__Clostridia.o__Thermoanaerobacterales
Thermococci	sk__Archaea.p__Euryarchaeota.c__Thermococci	sk__Archaea.p__Euryarchaeota.c__Thermococci
Thermodesulfobacteria	sk__Bacteria.p__Thermodesulfobacteria.c__Thermodesulfobacteria	sk__Bacteria.p__Thermodesulfobacteria.c__Thermodesulfobacteria
Thermomicrobia	sk__Bacteria.p__Chloroflexi.c__Thermomicrobia	sk__Bacteria.nr__Terrabacteria_group.p__Chloroflexi.c__Thermomicrobia
Thermoplasmata	sk__Archaea.p__Euryarchaeota.c__Thermoplasmata	sk__Archaea.p__Euryarchaeota.nr__Diaforarchaea_group.c__Thermoplasmata
Thermotogae	sk__Bacteria.p__Thermotogae.c__Thermotogae	sk__Bacteria.p__Thermotogae.c__Thermotogae
Thioclava	sk__Bacteria.p__Proteobacteria.c__Alphaproteobacteria.o__Rhodobacterales.f__Rhodobacteraceae.g__Thioclava	sk__Bacteria.p__Proteobacteria.c__Alphaproteobacteria.o__Rhodobacterales.f__Rhodobacteraceae.g__Thioclava
Thiotrichales	sk__Bacteria.p__Proteobacteria.c__Gammaproteobacteria.o__Thiotrichales	sk__Bacteria.p__Proteobacteria.c__Gammaproteobacteria.o__Thiotrichales
Tremellales	sk__Eukaryota.k__Fungi.p__Basidiomycota.c__Tremellomycetes.o__Tremellales	sk__Eukaryota.nr__Opisthokonta.k__Fungi.p__Basidiomycota.c__Tremellomycetes.o__Tremellales
Tymovirales	sk__Viruses.o__Tymovirales	sk__Viruses.nr__Riboviria.o__Tymovirales
unclassified Actinobacteria (class)	sk__Bacteria.p__Actinobacteria.c__Actinobacteria.nr__unclassified_Actinobacteria_	sk__Bacteria.nr__Terrabacteria_group.p__Actinobacteria.c__Actinobacteria.nr__unclassified_Actinobacteria_
unclassified Alphaproteobacteria	sk__Bacteria.p__Proteobacteria.c__Alphaproteobacteria.nr__unclassified_Alphaproteobacteria	sk__Bacteria.p__Proteobacteria.c__Alphaproteobacteria.nr__unclassified_Alphaproteobacteria
unclassified Bacteria	sk__Bacteria.nr__unclassified_Bacteria	sk__Bacteria.nr__unclassified_Bacteria
unclassified Betaproteobacteria	sk__Bacteria.p__Proteobacteria.c__Betaproteobacteria.nr__unclassified_Betaproteobacteria	sk__Bacteria.p__Proteobacteria.c__Betaproteobacteria.nr__unclassified_Betaproteobacteria
unclassified Burkholderiales	sk__Bacteria.p__Proteobacteria.c__Betaproteobacteria.o__Burkholderiales.nr__unclassified_Burkholderiales	sk__Bacteria.p__Proteobacteria.c__Betaproteobacteria.o__Burkholderiales.nr__unclassified_Burkholderiales
unclassified Clostridiales	sk__Bacteria.p__Firmicutes.c__Clostridia.o__Clostridiales.nr__unclassified_Clostridiales	sk__Bacteria.nr__Terrabacteria_group.p__Firmicutes.c__Clostridia.o__Clostridiales.nr__unclassified_Clostridiales
unclassified Enterobacteriaceae	sk__Bacteria.p__Proteobacteria.c__Gammaproteobacteria.o__Enterobacterales.f__Enterobacteriaceae.nr__unclassified_Enterobacteriaceae	sk__Bacteria.p__Proteobacteria.c__Gammaproteobacteria.o__Enterobacterales.f__Enterobacteriaceae.nr__unclassified_Enterobacteriaceae
unclassified Euryarchaeota	sk__Archaea.p__Euryarchaeota.nr__unclassified_Euryarchaeota	sk__Archaea.p__Euryarchaeota.nr__unclassified_Euryarchaeota
unclassified Flavobacteriaceae	sk__Bacteria.p__Bacteroidetes.c__Flavobacteriia.o__Flavobacteriales.f__Flavobacteriaceae.nr__unclassified_Flavobacteriaceae	sk__Bacteria.nr__FCB_group.nr__Bacteroidetes/Chlorobi_group.p__Bacteroidetes.c__Flavobacteriia.o__Flavobacteriales.f__Flavobacteriaceae.nr__unclassified_Flavobacteriaceae
unclassified Gammaproteobacteria	sk__Bacteria.p__Proteobacteria.c__Gammaproteobacteria.nr__unclassified_Gammaproteobacteria	sk__Bacteria.p__Proteobacteria.c__Gammaproteobacteria.nr__unclassified_Gammaproteobacteria
unclassified Lachnospiraceae	sk__Bacteria.p__Firmicutes.c__Clostridia.o__Clostridiales.f__Lachnospiraceae.nr__unclassified_Lachnospiraceae	sk__Bacteria.nr__Terrabacteria_group.p__Firmicutes.c__Clostridia.o__Clostridiales.f__Lachnospiraceae.nr__unclassified_Lachnospiraceae
unclassified Rhodobacteraceae	sk__Bacteria.p__Proteobacteria.c__Alphaproteobacteria.o__Rhodobacterales.f__Rhodobacteraceae.nr__unclassified_Rhodobacteraceae	sk__Bacteria.p__Proteobacteria.c__Alphaproteobacteria.o__Rhodobacterales.f__Rhodobacteraceae.nr__unclassified_Rhodobacteraceae
unclassified Verrucomicrobia	sk__Bacteria.p__Verrucomicrobia.nr__unclassified_Verrucomicrobia	sk__Bacteria.nr__PVC_group.p__Verrucomicrobia.nr__unclassified_Verrucomicrobia
Ustilaginomycotina	sk__Eukaryota.k__Fungi.p__Basidiomycota.nr__unclassified_Ustilaginomycotina	sk__Eukaryota.nr__Opisthokonta.k__Fungi.p__Basidiomycota.nr__unclassified_Ustilaginomycotina
Verrucomicrobia	sk__Bacteria.p__Verrucomicrobia	sk__Bacteria.nr__PVC_group.p__Verrucomicrobia
Verrucomicrobiae	sk__Bacteria.p__Verrucomicrobia.c__Verrucomicrobiae	sk__Bacteria.nr__PVC_group.p__Verrucomicrobia.c__Verrucomicrobiae
Vertebrata	sk__Eukaryota.p__Rhodophyta.c__Florideophyceae.o__Ceramiales.f__Rhodomelaceae.g__Vertebrata	sk__Eukaryota.p__Rhodophyta.c__Florideophyceae.o__Ceramiales.f__Rhodomelaceae.g__Vertebrata
Vibrionales	sk__Bacteria.p__Proteobacteria.c__Gammaproteobacteria.o__Vibrionales	sk__Bacteria.p__Proteobacteria.c__Gammaproteobacteria.o__Vibrionales
Virgibacillus	sk__Bacteria.p__Firmicutes.c__Bacilli.o__Bacillales.f__Bacillaceae.g__Virgibacillus	sk__Bacteria.nr__Terrabacteria_group.p__Firmicutes.c__Bacilli.o__Bacillales.f__Bacillaceae.g__Virgibacillus
Viridiplantae	sk__Eukaryota.k__Viridiplantae	sk__Eukaryota.k__Viridiplantae
Viruses	sk__Viruses	sk__Viruses
Xanthobacteraceae	sk__Bacteria.p__Proteobacteria.c__Alphaproteobacteria.o__Rhizobiales.f__Xanthobacteraceae	sk__Bacteria.p__Proteobacteria.c__Alphaproteobacteria.o__Rhizobiales.f__Xanthobacteraceae
Xanthomonadales	sk__Bacteria.p__Proteobacteria.c__Gammaproteobacteria.o__Xanthomonadales	sk__Bacteria.p__Proteobacteria.c__Gammaproteobacteria.o__Xanthomonadales
Yersinia	sk__Bacteria.p__Proteobacteria.c__Gammaproteobacteria.o__Enterobacterales.f__Yersiniaceae.g__Yersinia	sk__Bacteria.p__Proteobacteria.c__Gammaproteobacteria.o__Enterobacterales.f__Yersiniaceae.g__Yersinia
